############
#    7#  2##
# ### # # ##
#8   6  # ##
# # #S# # ##
# E  43 # ##
# #T########
#   #     ##
# ### ### ##
# # # # # ##
#0# # ### ##
# #5#     ##
# # # #1# ##
# #     # ##
############
############