############
#         ##
### # ### ##
#   T   # ##
### #E# # ##
#   #     ##
### # ### ##
#         ##
####### ####
#       # ##
###S### # ##
#       # ##
############
############