############
#        2##
# # #T######
# # #     ##
#S### # ####
#         ##
### ### # ##
#     #   ##
# # # # # ##
#       #E##
# # ### #1##
# 0     # ##
# #3# ### ##
# # # # # ##
############