############
#       # ##
##### # # ##
#4# #   # ##
# ### # # ##
#5  # #   ##
### # # #2##
#     #   ##
# ### # # ##
# #  036  ##
# ##### ####
#   # #   ##
# # # ### ##
# # 7 #   ##
#1# # ### ##
#  S#   E ##
##### # # ##
#     #   ##
# # # ######
#      T# ##
##### # ####
# # # # # ##
############