############
#T 0S # 2 ##
#1#3# # #E##
# # # # # ##
############