############
#   #    T##
# # ##### ##
# #    S E##
### # # # ##
# # # # # ##
############