############
# #S1     ##
# # # # ####
#     T0  ##
#E# # ### ##
# #   #   ##
############
############