############
# #       ##
# ### # # ##
#       # ##
###0#E### ##
#3 4# #   ##
#1### # # ##
# T #     ##
# #2#S# # ##
# # # # # ##
############