#############
#     # #2  #
# # # # # ###
# #    1# # #
# # # #######
# #     # # #
# # #E### ###
# #     TS  #
# # ### #####
# #       0 #
### # # #####
# #     # # #
#############
#############