#############
# #   #     #
### # # #####
#3   0  #   #
### ### #####
# #     #   #
# #4#########
#     # #   #
#2# # # # ###
#     #   # #
# # ### # ###
# # #T   1  #
### ### # ###
#  S# E     #
# ##### # ###
# # # # # # #
#############