#############
#   # #     #
# # # # # ###
#E    #     #
### # # # ###
# #  S    # #
### # ### ###
#         # #
##### # # ###
#   #   T   #
# # # ### ###
#     #     #
# # #########
# # # # # # #
#############