#############
#5       2  #
# # # # #T###
# #S#   #   #
##### ### ###
#  1    #   #
# ##### #####
# # 6E#   # #
# ##### #####
#  7# #   # #
##### # # ###
# #     #   #
# # ###3#4###
# #   # #   #
##### # # ###
#           #
### # #0# ###
# #     #   #
### # # #####
# # # # # # #
#############