#############
# #         #
### #E#######
# # #       #
# #7# # #6###
#     #     #
#1# #5# # ###
# # #3 S  # #
### # # #####
#4  0   T # #
#2# # #######
# # # # # # #
#############