#############
#           #
### ### #####
#      E  # #
# # # ### ###
# #         #
# # # # #####
#       #   #
### ### # ###
#     # #T  #
# ### # # ###
# # # #     #
# # ### # ###
#   # #  S# #
# ### # # ###
# #         #
# ### # # ###
# # #   # # #
# ### # #####
# #   #   # #
### ### #####
#       # # #
# ### # #####
# # # # # # #
#############