#############
#         # #
##### # # ###
#     #   # #
# # # #######
# #         #
### # # # ###
#   #   #   #
#E##### #####
#   #     # #
# ### ### ###
# #   # #   #
# # ##### ###
# #         #
# #S##### ###
# #   #   # #
# # # #######
# #       T #
# # # # # ###
#   # # #   #
# # # # # ###
# # # # # # #
#############