#############
#           #
# # # # #####
#       # 6 #
# ##### #####
#4  #  5#2  #
# # ###E#3###
#           #
### # ### ###
# #T        #
# # ##### ###
#   #       #
# ##### #####
#01   #   # #
# ### ### ###
#       #   #
# ##### #####
# # #   # # #
### ### #####
# # #S# # # #
###     #####
#############