#############
# #   #   # #
#######2# ###
# #   #     #
# # # # # ###
#           #
# # # ### ###
#         # #
##### # # ###
#1#  T  # # #
####### #####
#  E S    # #
# # # ### ###
# #     # # #
### ### # ###
#   0 3   # #
# ##### # ###
# #   #     #
# # # # # ###
# #   # #   #
# # # # #####
#     # # # #
#############
#############