#############
#  ST   0E  #
# ### # # ###
# # # # # # #
#############