#############
#    1      #
# # # ###3###
#40E    T 2 #
# #S# ### ###
# # # # # # #
#############