##############
#0#   #TE   ##
### ### ### ##
# # 5 #     ##
#2# # # # # ##
#   #   # # ##
# # # # # # ##
# # # # #   ##
# # #7# # #8##
#  4  1     ##
# ### ##### ##
#3# #    S# ##
####### #6####
# # # # # # ##
##############