##############
#2#4  #   # ##
# # # ########
#0    #     ##
# ### # # #E##
#           ##
# ###T##### ##
#     # # # ##
### ### # ####
#1        # ##
# # #####3# ##
# # #   # # ##
# ##### # # ##
#   S   #   ##
# # # ### # ##
# # # # # # ##
##############