##############
#   #1  #2  ##
# # # ### ####
#  0  # E   ##
### ### # ####
# 6   #T  4 ##
# # # # ###3##
#       5 # ##
# ### # ###S##
# # #       ##
# # # # # ####
# # # # # # ##
##############