##############
#  S 0  # # ##
# # # # # ####
#1#   #     ##
##### # # ####
#  E# # # # ##
### # # # # ##
#         # ##
# ##### # ####
#     #   # ##
# # # # # # ##
#     4     ##
#2### # # ####
# # #   #   ##
# ### # # # ##
#     #   # ##
# # ### ###3##
# T # #     ##
##############
# # # # # # ##
##############