##############
#0#   E     ##
# # # ### # ##
# #       # ##
# # # # # # ##
#   #  T   3##
##### ### # ##
# S    6#   ##
# ##### ### ##
# # #   #   ##
# # ##### # ##
#   # # #  4##
# # ### # # ##
#1    5 #   ##
####### # ####
#2# # # #   ##
##############
##############