##############
#   #       ##
# ### # # ####
#   # # # # ##
# # # ##### ##
#          1##
# ##### # # ##
# #       # ##
# # ### ### ##
# #  E     S##
# ### ### ####
#           ##
# # # ### # ##
#       #   ##
# # ##### # ##
#     #   # ##
##### # # # ##
# #0  #    T##
# # ##### # ##
# # #     # ##
##############
##############