##############
# # 4     # ##
# # #####T####
# # 2   #  0##
####### ### ##
#   #   #   ##
# # # # # # ##
#     # #   ##
# ### #####1##
#     # #   ##
# # # # ######
# # # #     ##
#3###S### # ##
#     # # # ##
### # ### # ##
#           ##
##### # # # ##
#   #     # ##
#E# # # ### ##
# #   #   # ##
####### # # ##
# # # # # # ##
##############