##############
#####     ####
####       ###
####       ###
#####     ####
###### 2  ####
#######  #####
####### ######
#####   ######
####     #####
##      1##  #
#            #
#    S       #
##    T      #
######      ##
######     ###
######     ###
#######   E###
##########   #
##########0  #
##########   #
###########  #
##############
##############