##############
#0      #   ##
# # # #E### ##
# #         ##
# # ##### # ##
# #        2##
# ### # ######
#     T   # ##
# # # ### # ##
#     # #   ##
# # ##########
# #         ##
##### ##### ##
#   # # # # ##
# # # # #4####
#       #   ##
# # ##### ####
# #         ##
# ######### ##
# #S 1#     ##
# # ### ######
#   #   3   ##
# ### # ### ##
# #   #   # ##
##############
##############