##############
#T1#####2   E#
##############
#S         0 #
##############