##############
#   S  ####  #
#   0###### 2#
##     ###   #
#E # #T 1#   #
##############