##############
# #         ##
### # #T# # ##
# # #     S ##
####### # # ##
# #   # E   ##
##############
##############