##############
#   T       ##
# # ####### ##
#     #     ##
# # # ### # ##
#E  # #  S# ##
# # # ### # ##
# # # # # # ##
##############