###############
#   # # #   # #
# #E####### ###
#   #   #   # #
# # ### # # ###
#   #         #
# #S#2#########
#       #     #
###0### #######
# #         # #
### # # # # ###
# #   #1 T    #
###############
###############