###############
## #   ########
#   # #########
#  ############
#  4###########
#  2   ########
#      3#     #
##     #   ## #
##    #  ###  #
#  1 ######   #
##   ######   #
## T#####E  S #
## #####      #
# # ####      #
#          0  #
#             #
###############