###############
#   #   #   # #
##### ### # ###
# # # # T # # #
# #S### # # ###
# #         # #
# # # ##### ###
# #           #
# ### # # # ###
#   #       # #
# ###E# ### ###
# #2#  0# #   #
# #1# #########
# # # # # # # #
###############