###############
#  3          #
# #1### # #####
#   # # 0 #   #
### ### # # ###
#             #
# # ### #######
#   # #S      #
# ### # ### ###
#       # # # #
# ####### # ###
#   # ET      #
# ##### #######
# #   #       #
##### # #######
#           # #
# ##### # #####
#    2    # # #
# ##### ### ###
# # # # # # # #
###############