###############
# # #   #     #
####### ### ###
#3E   #1# # # #
# # ##### # ###
# T # #     4 #
##### # # # ###
#       # 5   #
### ####### ###
# # # # # #   #
# ### ### # ###
# # # #     # #
# ##### # # ###
# #        S  #
# # # # ### ###
#   # # # #   #
# # ###0# # ###
#   #2        #
### # # # #####
#   # #   #   #
### # ###6# ###
#   # #       #
# ######### ###
# #           #
# # # # # # ###
# # # # # # # #
###############