###############
#####  ##    ##
#######  # ####
## ####   #####
#5   #    #####
#     #    ####
###   #     # #
#S##  #       #
#   ##        #
# ##         ##
#  # 43   #  ##
#   ##   ##   #
#  ## E  ###  #
# 1##  ## #   #
#   ##  #    ##
#        ##   #
###        #  #
#### 0   ##   #
###     #   T##
####    ##   ##
###### 2#     #
###  #        #
#    #        #
###############