###############
# #   # S3T   #
# # # # # # ###
#  E2     #   #
#1# #0# # #####
# # # # # # # #
###############