###############
#  T    E # 0 #
# # # # # # ###
#     #  1# # #
######### #3###
# 52  #       #
# #6### ### ###
# #7# #  S#   #
# # ### #4# ###
# # # # # # # #
###############