################
#   #     #   ##
### # # ### # ##
# #   #    S# ##
# # # # ### # ##
# T #     # # ##
# ###0# # # # ##
#2  # #     # ##
### # ### ### ##
#       # #   ##
# # ###1##### ##
#     #E#     ##
# ### # # ### ##
#   # # #   # ##
################
################