################
#   #   #   # ##
# #T# ### # # ##
# 3   #   #   ##
###4##### # #5##
# #           ##
##### # ### # ##
#   #   # # # ##
######### # # ##
#  1  #     0 ##
# # #E##########
#   #   #     ##
# # # # # # ####
# # # #      S##
# ##### ##### ##
# #     #     ##
# #2# ### ######
# # # # # # # ##
################