################
# #   # #     ##
# ####### # # ##
#     #   #  S##
######### ### ##
#       # #T  ##
# # ### # # # ##
#           # ##
#E# # # # # # ##
#   #       # ##
# ####### ### ##
# # # # # # # ##
################