################
#      STE    ##
### # # ### #0##
# # # # # # # ##
################