#################
#   # #S      # #
# # # ### # # ###
#     #         #
# # ### # ### ###
#   #       1   #
####### # #######
#         #   # #
# # ###E#########
#   # # #     # #
# # # # # #######
#T  # #       # #
### #######0# ###
# # # # # # # # #
#################