#################
# # #       # # #
#E# # ##### # ###
#     #         #
# # # # # # #####
#         T #   #
### # # # # # ###
#   #   #   #   #
# #S### ### # ###
#   # # #   #   #
### # ####### ###
# # # # # # # # #
#################