#################
#   #    T      #
# # # # # # # ###
#   #     #     #
# # ##### ###0###
#   # #     #   #
# ### # # # # ###
#       E # #   #
# # ### # #######
# # # #     #   #
# ### # ### # ###
#     # # #     #
# # # # ### #####
# #   # # #     #
# # # # # # # ###
#   # #       # #
#####1###S# # ###
#   # # # # #   #
#################
#################