#################
#   # #     # # #
### #T### #######
#       #   # # #
### # # ### # ###
# #   # #       #
# # # # # ### ###
#   #E  # #     #
# # # # # #S#####
#   # #     #   #
### # # ### # ###
# # #   #     # #
#################
#################