#################
# #  1  #       #
# # ### ###S# ###
# #4#   #T    # #
# ##### ##### ###
#03         # E #
# ### # # # # ###
# # # #         #
# ##### ###5# ###
#     # # #     #
### # # # # #####
#       #   # # #
# # # #2### # ###
# #   #     # # #
### ### # ### ###
# # # # # # # # #
#################