#################
#         # #   #
# ### #E# # #####
#   # # 1     # #
##### # ### # ###
#   #T# #   #   #
# ### # # # # ###
# # # #   # #   #
# ### # # #######
#2   3   S#     #
# # # ####### ###
# #       #     #
# ### ##### # ###
#     # #   # # #
### # # # ### ###
# 0     # #   # #
#################
#################