#################
# #   #     #   #
######### # #####
#1# # # #   #   #
### # ###########
#   # #     # # #
# # # # ### #####
#   # # # #   # #
####### # # #####
#       #       #
# ##### # # # ###
#   #           #
### ###T# #######
# # #     #     #
# # # # # ### ###
#     #   S     #
### ##### # #####
#         # 0 # #
# # # # # # # ###
#     #     # # #
# # # ##### # ###
# #   #     #   #
# ###E# # #######
#       # #   # #
##### # ##### ###
# # # # # # # # #
#################