#################
# #   S   # # # #
### # ##### # ###
#     # #       #
# ####### # # ###
# # #   #   #   #
#2### ### ### ###
# #       # # # #
# ### ### # #####
#   #       # # #
### # ### # # ###
#     #   #  0# #
# ### ### #E#####
# #     #   #   #
# # # ##### #####
# # # #   #   # #
### # # # # # ###
#  1  #   4 #   #
#5# ##### ### ###
#   T   #   #   #
# ### ### # # ###
#   # #   # #3# #
########### # ###
# #   #   #   # #
#################
#################