#################
# T # # #       #
# ### # # #######
#           #   #
# # ##### # # ###
#         #   # #
### # ##### #####
# # #   # #     #
# # # #####5#E###
#         # 0 # #
# ##### # # # ###
#   #   # # #   #
# # # ### ### ###
#   #     #     #
# ##### ### #####
# #      2      #
# ###1### # #####
# #    4  # # # #
# ### ### ### ###
# # # S #   #3# #
### ### ### # ###
# # #   #   # # #
#################
#################