#################
#S    #    0#2  #
#T#E###1# ### ###
# # # # # # # # #
#################