#################
#   #   TE#     #
# # ### # #######
#             # #
# # # ##### #####
#           #   #
# # # # ### # ###
# S # # #     # #
#################
#################