##################
#     2     # # ##
# # # ### ### ####
# #   # #   S # ##
### # # ##### ####
# # #           ##
### ### # ###6####
# # #       # 0 ##
### # ### # ######
# #3  # #     # ##
# # ##### #####4##
#   #     #1  # ##
###T#E# # # # # ##
#   # # #     # ##
### #####5# ######
#     # #     # ##
# ### # # ### # ##
# # # # # # # # ##
##################