##################
#  0        #   ##
# # # ### # #E####
#  2# # # #     ##
### # # ### ### ##
#           #   ##
# ### #S### #4# ##
# #  3#  1#     ##
# # ##### # # ####
# #        T    ##
# # ### # # # # ##
# # # # # # # # ##
##################