##################
#   # #E  T     ##
# ####### ### # ##
# # #   #     # ##
# # # # # # # ####
#         #     ##
# # # ####### # ##
# #   # # 1    2##
### # ### ##### ##
#  3    #0   S  ##
# ### # # # ### ##
#         # # # ##
# ######### # ####
# #   # #     # ##
##################
##################