##################
#       3       ##
# # ##### # ######
#   #     #   # ##
# # ##### ### ####
# #2            ##
#S# # ##### # ####
#  E# # 5     # ##
# # # # ### #4# ##
# #     #1#     ##
### # # # # # ####
# # # #    T    ##
# ### # ###0# ####
# # # # # # # # ##
##################