##################
#  T#   # #   # ##
### ##### ### # ##
# #  4    # #   ##
# # ### # ##### ##
# #     # #1  # ##
# ### # ### ### ##
#   # # 2 # #   ##
### # # ##### ####
#             # ##
### # # # # # # ##
# # #     # # # ##
############# # ##
# # #   #    E# ##
# ##### # ##### ##
#   #   #     # ##
# # # # # # # # ##
#     # #       ##
### # ###3### ####
#0      # # S   ##
# # # ### # # # ##
#     #         ##
### ### # ##### ##
#   #   # # # # ##
##################
##################