##################
# #   #        2##
####### ### #0####
# # #           ##
# ####### # # # ##
#   #     #   # ##
### # # # # # # ##
#   #     # #   ##
# # # # # ########
#   #   #   # #1##
#T# # ### # ######
#E# # #     # # ##
# ####### # # ####
#   #          S##
# ##### ### # ####
#               ##
# # ### # # # ####
# #         #   ##
### ### # #####3##
#       #   #   ##
# ####### ### # ##
# # # # # # # # ##
##################