##################
#4##  ##       ###
#  2 #3#   T1  ###
#   #  S# 5 ######
#  #670# E #######
#  ######  #######
##################