##################
#2  #           ##
# # #S# # ### # ##
#   # # E 0   1 ##
# ##### # ### #T##
# #     #   #   ##
##################
##################