##################
#         #   #2##
### # ### ##### ##
# #E# # S     # ##
# # # # ####### ##
# 4   T    3# # ##
# # # #0# # # #1##
# # # # # # # # ##
##################