##################
#     S         ##
# # ### # # #2# ##
# 1   #   #     ##
### # ### # # #T##
#       #   # E ##
####### ### # # ##
# # # # 0 # # # ##
##################
##################