###################
###     #      ####
####   # #  #######
####   ##    ######
###      #    #####
##      ##  ## ####
#     #  #  #   ###
##  # ###  ##   T##
#  ### # #        #
#  ###  E##       #
#####S   #        #
######        #   #
#####        ##   #
####        ##    #
###################