###################
##    ######     ##
##    ###  #     ##
####  #  #  # # ###
######  ###  ## ###
#####  #       # ##
#### ##       #  ##
### # ###  ET ##  #
###  #  #   ##    #
#### ##      #    #
###  ## #    ######
#       ##   ######
#     S #     # ###
#         ####   ##
#          ##### ##
#           ###  ##
###################