###################
#     #           #
# ### # # ### #####
# 1 #     # #0# # #
# # ### ### ### ###
#   #   # #       #
# # # # # ### #####
# # #             #
### ### # # ### ###
#     #   #   # # #
# # # # # #########
#   #   # #   #   #
### ###S##### # ###
# #   #     #     #
# ### #T### # # ###
#       # # # #   #
### # #E### ### ###
#       # #     # #
# ### ### ### # ###
# # # # # # #   # #
###################
###################