###################
#####  #     #    #
#####   E        ##
#####    ## # ##  #
#####   ####### # #
# #       #####  ##
#          #  #   #
#  # 2    ##  ## ##
#####      ########
# ###      #  #####
# ####         #  #
#  ##      ##     #
#  ##  #  ####    #
#  #  # #  ###    #
#0  #S # #T# ##1  #
#  ###    #   # ###
#     #    ## # # #
#     #   #### #  #
## ###      # ## ##
######       # ## #
#####          #  #
######   # #    # #
#######  ##### #  #
###################