###################
#   #     # #     #
### # # ##### # ###
# # #   #         #
### ##### ### # ###
# #         #   # #
### ####### # # ###
#S#   # # #   #   #
# # # # # ### #####
#   # # #     #   #
### ####### # # ###
#     T # # # # # #
##### # ### # # ###
#     #     #     #
##### # # # # #####
#   # # #   #   # #
### ### ###########
# # # # #         #
# ### # ### ### ###
#      E        # #
### ##### # #######
#     # #         #
# # ##### # # # ###
# # # #     # # # #
###################
###################