###################
#      ####       #
#   0###### 2  ####
##     ###      E##
#  # #T 1#S  ######
###################