###################
#   #   # #4 1#   #
#E#5# ### ### #0###
#    S   7 6      #
# # # # #T# ### ###
# # #  3  # #  2  #
###################
###################