###################
# #   0   # 51#   #
# # #S### # #######
#     T #   4  6# #
# #3##### ### # ###
# #     #    7    #
#E###2# # #8# # ###
# # # # # # # # # #
###################