###################
#   #   # #   # T #
### # ###2# # # ###
# 0 #   # #       #
##### # ### ### ###
#3    #   S     # #
# ### # # # # #####
#  1  # # E # # # #
###################
###################