###################
## ###    ######  #
#   ##    ####### #
#  # #     #####  #
##  #  E   #####  #
#####      ###### #
####        ##### #
#####   S  ###### #
####### T #########
######## ###  #####
###################