####################
#     # #     # # ##
# ####### # # # # ##
#     #       #   ##
# ####### # # #0####
#       #   #   # ##
# ### ##### ##### ##
#   #   # #   #1  ##
# #7# # # ###2# # ##
#T# # # # #   #5# ##
# ### #E#6# # # ####
# #  4# #S# #     ##
# ### ### # # # ####
# #   #     # 3 # ##
# # # # ### # # ####
# #   #     # # # ##
# # # # # ### # # ##
# # # # # # # # # ##
####################