####################
#       #         ##
### # # # # # # ####
#   S #     #  T  ##
### ##### # # ### ##
#   #             ##
# # # ### #E# # ####
# #       # #   # ##
### # # ### ### ####
#         #   #   ##
# # # # # ### ### ##
# # # # # # # # # ##
####################