####################
# E  S   1#       ##
##### # ### # ### ##
#    3# #        2##
# # # # ### ##### ##
# #         #     ##
### ### # # # # ####
#   #       #  T  ##
#0# # ### # # ### ##
#   #   # # #   # ##
####################
####################