####################
#4   E         T# ##
### ### ##### ### ##
# #2# #   #    1 0##
# # # # # # ###S#3##
# # # # # # # # # ##
####################