####################
#     # #E  # 1 # ##
# # ### # ### ### ##
#     #          0##
### # # # # ### # ##
# #     # # # S   ##
# ##### #######T# ##
# # # # # # # # # ##
####################