#####################
#####               #
# ##                #
# ##   T         S###
# # # ###   ##   ####
###  #### 2  #    ###
#    E #         ####
#    #      1   #####
#    ##      #0   # #
#     ##    # #3    #
# ## ##      ##    ##
#####################