#####################
# 1 # #   # # # # # #
# ### # ### # # #####
# #     #     #     #
# # # # ### # # #####
#    E    S  2  #   #
### ### ##### # # ###
#   #   #  0        #
### ### ### ### # ###
#     #     #     # #
### ### ###T##### ###
#   # #   #     # # #
# ##### # ##### # ###
# # # # # # # # # # #
#####################