#####################
#     # #   # #   # #
##### ### # ##### ###
#         #   #     #
# # # ##### # # #####
#         S   #     #
# ###E# ##### # #####
#   #     # # #     #
# # ### ### # #######
# # #     #   #     #
### # ### ##### # ###
#               #   #
### # # # # ##### ###
#   #   #  T#     # #
# # # ### # # ### ###
#       # #   #   # #
#####################
#####################