#####################
#                   #
# ##### ### ### #####
#     2   #  5#   # #
# # ### ### ### # ###
#   #   T6#   # 3   #
# ### # # #7# ### ###
# #   #   #  0#8#   #
# # # # # ### # # ###
#     #       #  E# #
#S# # # ### # # #####
#       # # # # # # #
# # ### # ### #######
#     # #       #   #
# ### ### # ### # ###
#4#   #     # #1# # #
# # # # # # # #######
# # # #       #   # #
########### ##### ###
# # # # # # # # # # #
#####################