#####################
#     #S T     E    #
# ### # ### ##### ###
#           # # # # #
# ### ### # # ### ###
# # #   #   # # # # #
#####################
#####################