#####################
#   # #T      #     #
# # ### ##### #######
#           #   #   #
# ### ######### # ###
#          E        #
# # # #S### #########
#   #               #
### ##### ### # #####
# # # # # # # # # # #
#####################