######################
#     #   #         ##
##### # ### # # # # ##
#     # #E     2     #
# # # # # # # ##  #T #
#   # #         # #1##
########### # # # #  #
#     #   #          #
# ######### ### ### ##
# # #   #  0  # #   ##
##### ### #S# # ######
#     #   #   # # # ##
# # ### ### ### ### ##
#     # #       #   ##
### # # # # # # # ####
#   # #     # # # # ##
##   #  #     #      #
######################