######################
#   # # # #       # ##
### # # ### # # ### ##
#   # #   #S   T    ##
####### ### ### # #0##
# 5         1   #   ##
# ### ### # # # ######
#   # #   #  3      ##
# # # ##### # ### # ##
#   76# # #    2  # ##
# # # ##### ##### # ##
#   # #  E4 # # # # ##
######################
######################