######################
# #         # #     ##
# ####### ### # # # ##
# #     #      6    ##
# # # # # ####### # ##
# #   # # #   #   # ##
# # # # # # ### ### ##
#   # #   # #   #   ##
### # # ##### ##### ##
#   #   #E         0##
# # ##### # ##### # ##
#      5# 4   # #   ##
# # ##### # ### ### ##
#  T#   2 # #     # ##
### # # # # # # # # ##
#S1   #         #   ##
# # ########### # # ##
#3  # # #   # # #   ##
# ##### # # # # ######
# # # # # # # # # # ##
######################