######################
#     E             ##
#T### # #S# ### ### ##
# # # # # # # # # # ##
######################