######################
#    T      #   # # ##
# # # # # # ### # # ##
# #ES       #     # ##
### # ### ##### ### ##
# # # # # # # # # # ##
######################