######################
#                 # ##
# ##### # ### # #E# ##
# T #  1    # #   # ##
# # #S### ### # # # ##
#   0       # # #   ##
####### # ### # # # ##
# # # # # # # # # # ##
######################