#######################
# # #1#   # #   # # # #
# # # # # # # # ### ###
#   # #      6#       #
### # #### E##### # ###
# #   #S   4      # # #
# ### # ### # ### #####
# #   # # #           #
# ### # ####### ### ###
# #   #               #
# ### #T### #####5# ###
#     #   #    3 0  # #
### # ######### ### ###
#  2    #   #   # # # #
# ### ### ### # #######
#   #       #     # # #
#######################
#######################