#######################
#   #     #   #   #   #
### # # ### ###0### ###
# #     #     # # #   #
# # ### # ### # # #####
# #   # #       #     #
### #S# #######T#E# ###
#       #   3 # #     #
# ###1### ### ### # ###
# # # #               #
# ##### # # # # # # ###
#   #     4           #
####### # # # # # # ###
# # # # #   #     #2  #
#######################
#######################