#######################
#  T2S E    # 0  4 3  #
# # # # # ###1# # # ###
# # # # # # # # # # # #
#######################