#######################
#     #      1#E0     #
# # # #T######### # ###
#        S  #         #
# # # # # # # ### # ###
#     #     #3#2  # # #
#######################
#######################