#######################
#0 7#       #     E   #
# #4# ### ###3# ### ###
# #   # #     #   #   #
# # # #S# # ### # #T###
#5      #6# #         #
#2##### ##### # ###1###
# # # # # # # # # # # #
#######################