########################
# #   # #   #       4 ##
# ### # # # ### # # ####
# #   2   # 3       # ##
##### ### # # # # ######
# #     #     #       ##
# ####### ####### # ####
#   # #  1#   # # #   ##
##### ### ##### # # ####
#     #      T        ##
### ### # # # # # # ####
#       # # #       # ##
######### # # ###S# ####
# # #     #     0 # # ##
# # ### # #E### # ### ##
# # # # # # # # # # # ##
########################