########################
#   #   #   #     #   ##
#S# # # #4# ### # # # ##
#T  # # #         # # ##
# # # # ####### # ######
#0        # #   #   # ##
# ##### # ###2###3# ####
#   # #    E  #     # ##
# #5### # # ### ### # ##
#             # # #   ##
# # ### ### ####### ####
# # # #   # # #   #   ##
# # # # # ### # # ######
#  1# #   # #   # # # ##
########################
########################