########################
#       #             ##
# # # # ### # ##### # ##
#       S # #   # # # ##
#######1# # # # # # # ##
#         # #3  #     ##
# ### ####### # ### #E##
#         # #         ##
#####T# ### # # # # ####
#     0   # #   #     ##
########### # #2# ### ##
#   # #   # # #   #   ##
########################
########################