########################
# #T 2  1E3       6   ##
###S# #4# # #5# #0# # ##
# # # # # # # # # # # ##
########################