########################
#0 1  3       4 #5    ##
# # ### ### # ###E######
#           # T2#S# # ##
########################
########################