########################
# # #S      #0       4##
# # ###6# # # # # # ####
# 52 3  # # #       # ##
# # #E# ##### # # # # ##
#T# #     # #   # 1   ##
########################
########################