########################
#1    # # # # # # #8  ##
# # #0#4# ### # # # # ##
#   E3#   #           ##
#7# ###5### #6### # # ##
#T#2#     S #   #   # ##
# # # ####### # # ### ##
# # # # # # # # # # # ##
########################