########################
#  0    # # # #       ##
# # ### ### # # ##### ##
#1#     #   T     # S ##
# #2#3# ### # # # # # ##
#       # #5      E # ##
# ### ### ### ### # # ##
# #4# #   # # #   #   ##
########################
########################