#########################
# #               # # # #
# # # ### ### # ### #####
#T      #     #     #   #
### ##### # # ### # #####
# #   # #       # #     #
# # # # ### # # # # # ###
# E     #         #     #
# ### ### # # # # # # ###
# # # #S# # # # # # # # #
###     #################
#########################