#########################
####         ############
###      4    ###########
###   1        ##########
###     ###        ######
###T   #### 3      S#####
###    ####        E  ###
###                    ##
###               #    ##
###         2    ###  ###
####  ###### 5  #########
#############    ########
#############   0########
##############  #########
#########################