#########################
#   # S   #             #
### ### ###5######### ###
# # # 4 # # # #  7  #   #
###0# ### # # # #2# #####
#             # #   #   #
# ######### # # #6### ###
#  3# # #   #   # # E   #
# # ####### ### # # # ###
# #         #1#  T    # #
### # # # ### # ##### ###
# # # # # # # # # # # # #
#########################