#########################
#   # #       #     #   #
### ##### ### # #3#5# ###
#         6   # # # # # #
##### # # # # # # #######
# #         #     2   # #
# ### ### # # # ### # ###
# # # #    4        # # #
# # ### ##### # # # # ###
# # # # #7#  T    1 0 # #
# # # # # ### ####### ###
# # # #S            #   #
##### # ##### # ### # ###
# # # #  E  # # # #  8# #
#########################
#########################