#########################
#   S     #           # #
# ### # # # # ### # #####
# # #E  #T#             #
# ### # ####### # # # ###
#         # #         # #
# ### ### # ### ### #####
#   # # # # # # #   #   #
# ########### ### # # ###
# # #   # # # #   #     #
# ############# # # # ###
#   # #                 #
### # # # ### ### # #####
# #   # # #     # #     #
# # ##### # # ### # #####
# #   #               # #
#########################
#########################