#########################
#    0      #   E     # #
# # # # # # # # #S# # ###
#           # #  1      #
### # #T############# ###
# # # # # # # # # # # # #
#########################