#########################
#6#   #########   ##    #
#  ############      ####
#     ## ##  #     4#####
#   2      #  1     #####
#   TE5 ###  S30   ######
# ###  ###        #######
#########################