#########################
#5    S #   #         # #
# ### ##### # # ###2#####
# #   #1            #   #
# # ### #7# #8##### # ###
#        4    #         #
#3# # ####### ### # #6###
#    T# # #     #       #
### # #0# #E######### ###
# # # # # # # # # # # # #
#########################