##########################
#   ####   #3      # #   #
#    ###   #    1 ##  #  #
##  #######   #  4  ######
#   ######   ###   #  ####
## ######     #   # T #  #
#########   2 # 6##   #  #
# ######      ##  ## # # #
# ###  ## ### #7   #0## ##
#S # #  ####   # #   ## ##
#    ##  ####  #### ## # #
#  5   ##8#  #E#####     #
##   #    #   # #####   ##
#######  ####   ###  # ###
##########################