##########################
#   #   # # # #        S##
# # # # #T# # # # ### # ##
#        3 E 40       # ##
### ###### ## # # #5# # ##
# 1     # #   # #       ##
# ## ## ### # # # # # # ##
#             # # # #   ##
### # ##### # ### ### ####
#2    # # #   # # # #   ##
##########################
##########################