##########################
# # #1#   # #     # # # ##
#######0#E# #5# # # #4####
#   #         #   # #   ##
# # # # # # ##### ##### ##
#  2  # #         # #   ##
### # # # # # # # # # ####
#   # #   #             ##
### # # # # ###S# ##### ##
# # # # # #  T          ##
# # # # # ### # ### ######
#   #   #   #   # #3#   ##
##########################
##########################