##########################
# E    7  #  TS   # 2   ##
# # #4### # #1### #0# # ##
#   # 5 #   #   # # 3 #6##
###  ####    ######   ####
##########################