##########################
#      1S   E #       # ##
### # ###2# # # # # # # ##
#     #       # #   0   ##
# # #T### # # ### # ### ##
# # # # # # # # # # # # ##
##########################