##########################
#   #  T# # 4         # ##
# ### #1# ##### # ##### ##
# #       S     #       ##
# # # ### # #2# #3#E#0# ##
#     # #     # # # #5# ##
######  #######       ####
##########################