##########################
#   #           #   #   ##
##### ### # # ###T### ####
# #     #            4#2##
### ##### # # # ### # ####
# E #   05    #       # ##
#1# # # # # #######S# #3##
# # # # # # # # # # # # ##
##########################