###########################
# # #       # E   #   #   #
### # ### ##### ####### ###
#             #         # #
# # ### # ### ##### # #####
#   #   #     #         S #
# # # # # # ### # # # # ###
#   #           # # #0 T# #
# # ##### ### # # ##### ###
#             #           #
### ##### ### # ### ### ###
# # #   # # # # # # #   # #
# ##### # # # ### ### # ###
#   # # # # #1    #   #   #
###                       #
###########################