###########################
#     #     #   #   3   1 #
# # ########### ##### #####
#T        #   # #   #     #
# # # # # ##### # ##### ###
#      0  # # # # 4   # # #
### ######### # # ##### ###
#     #     # #       #   #
# # # ###E# ### # ###S# ###
# #2# #         # #     # #
# # # # # # # # ### # # ###
# # # # # # # # # # # # # #
###########################