###########################
# #         #   # #       #
# # ######### ### # # #####
# # #      E  # #   #     #
# # # ### # # ######### ###
#     #     #   #   # #   #
# # # ### ### ### # #######
#   #   # # # #   #   #   #
# ##### ##### # ### ### ###
#   # # #   # # #   # #   #
##### # ####### # ##### ###
# #T#                 #   #
# # ### # # ##### # # #####
#   # #       # #         #
# # ### # ### ##### # # ###
# #S  #       #   # #     #
# ### # ##### # ###########
# # # #       #           #
# ### ### # ### # # # #####
# #   #     # #   #   #   #
# ### # # ### ### ### #####
#   #         # #         #
### ### ### ### ### # #####
# # # # # # # # # # # # # #
###########################