###########################
# #   # 2     #T  #  3    #
### # # # # # # #####0# ###
#   #           #  S# #   #
# # # ###1#E### # # ### ###
# #   #   # #   # #       #
###########################
###########################