###########################
##    E       #####       #
###8   4##   ########     #
####   ###  16 ######3### #
###  0      #  #####  # ###
### 7  5S####  #####     ##
####      ##2 ####### T  ##
####      #  ########   ###
##### # #    ########    ##
###########################