###########################
#     #     #   # #       #
#########1### # # # # # ###
# #   #    E  0         # #
####### # # # # ###S# # ###
#       # #   #   #     # #
# ##### ### # # # ##### ###
#     # #   # #       #   #
##### # ###########T# #####
# # # # # # # # # # # # # #
###########################