############################
# # # #   #     1     #  E##
#3# ### # # ### ### # # ####
# #       #     #   # # # ##
##### # ### ### # ### # # ##
#     #   # #     0 # 5   ##
# # ### # #6# ### ### # # ##
# 2       #     # # #   # ##
######### ####### ### ### ##
#     #   # #S#     #   # ##
# # ######### # # # ### ####
# # # # # # 4 #  T# # #   ##
## ###    ####    #####  ###
############################