############################
# #       #  2# # # #     ##
# # # # # ##### # ### #8####
# #   1 #   # # S   5     ##
# # ### # # # # # ### ###3##
#   # #     #7       0# # ##
# # # # # # ### ### ##### ##
#         #  6#   # #  4  ##
#E### # # #####T### ### # ##
#   # # # # # #     #   # ##
##              ############
############################