############################
#     #      1# #         ##
# ### # # ######### # ### ##
# # #E    # #   # # #   # ##
# ### #5# # ### ### #0# ####
#   #     # #   #   #     ##
##### # # ### # # ### # ####
# #     #2T   # # #   # # ##
# # #4### #7# # # ### ### ##
# # #   #         # #     ##
### ### ### #6######### ####
# #   S         #   # # # ##
# ### ### # # ##### ########
#   #         #  3      # ##
# # # ### ##### # # ### # ##
# # # # # # # # # # # # # ##
############################