############################
#     0         1 E     S ##
#T### # ### # ### # # # # ##
# # # # # # # # # # # # # ##
############################