############################
#     #             #     ##
# # # # ### # ###3# #0### ##
# #2# 1 TS  #           E ##
###  ## ###       ##########
############################