############################
#     #S#E          #     ##
# ### # # ### # # # # # # ##
#   #     #       #   T   ##
# # ##### # # # ### # # ####
# # # # # # # # # # # # # ##
############################