############################
#     1   64#2    # #   8 ##
# # ###7##### #T### # ######
#  S E   3  # #     # 5   ##
# # ### ##### # ### # # ####
#   #   #   #     # 0 # # ##
############################
############################