############################
#   #   0     6E 4     T  ##
### # # ###5### #####S#3####
# #     # #      2        ##
# # ### ### ### # ### # # ##
# # #   #   # #   # # #   ##
# ##### # ### # #1##### # ##
# # # # # # # # # # # # # ##
############################