############################
#T#   #         # #      4##
#2# ##### # # # ##### # ####
# #3# # # # #       #     ##
# ######### # ### ####### ##
#   S   #     # #         ##
# # ##### # ### # # ##### ##
#   #   #    0    1 # # E ##
############################
############################