############################
#   #           #S T    1 ##
##### # ##### # ##### # # ##
#             #       E   ##
# # ####### ### ### ########
#   #     #     0 # #   #3##
##### ### # # # # # ########
# #   #   # #    2#     # ##
### # ##### ##### # # ### ##
# # # # # # # # # # # # # ##
############################