#############################
# # #   #0#       #     # # #
# # ### # # ### # # # # #####
#   # # #   #   # # #E      #
##### ### # # ### ### # # ###
#       #         # #   # # #
# ###T# ### ### ### # # #####
#   #     # #     #         #
# ##### # # # # # # # ### ###
#     #   #           #   # #
### # ######### ### # ### ###
# # # # # #         #     # #
# # # ##### ######### #######
# #           S   #     # # #
# ### ### ### ##### # # # ###
# # # # # # # # # # # # # # #
#############################