#############################
# #             #         # #
# # # ### ####### # # # # ###
# #     # 0 2 # #           #
##### ### # # # ### # # #####
# #                 #   #   #
##### # # #T#####1###########
# #   #  E    #   #    S    #
### ### # ### # # # # # #####
#   #   # #               # #
#############################
#############################