#############################
#### # 0       ##########  ##
#3#  4         5#  # # 6#  ##
# ##                      ###
#         7  2      8    ####
###            1    S     ###
#####      #          E  ####
# ###    ####      T    #####
# ## #  #####          ######
#   # #########   #     #####
##   # #  ##  #  ##    ######
#       #        ###    #####
#############################