#############################
#   #     # #           #   #
# ### ### # # ### ### # # ###
#   # # #   #       #   #   #
# # # ##### # # ### ### # ###
#     #   #   #6# #2  #     #
# ### ##### # # ### # #4#3###
#   #    7# #   #     # #   #
# # # ### ### # #######5#####
#   # E         #   # #   # #
##### ### ##### # # # # # ###
# #T0 #   S # #1  #         #
# ### # ####### # ### # # ###
# # # # # # # # # # # # # # #
#############################