#############################
#    E#           # S1      #
### #3# # # # # # # # # #####
# #   # #T2 # # #       #0  #
#############################
#############################