#############################
#     #   #     #       #   #
# # # # # ### # # # ### #####
# #   #     0 #    2# 4     #
######### #5# # ### # ### ###
# # 1 # 3E#  T# # # S     # #
#############################
#############################