#############################
#   #3        #    S      5 #
# # # # ######### # ### # ###
# # #     #2  1     6   # 0 #
# ### # ### # # ### ##### ###
# #   # #E  T        7  # # #
# #4# # # # # ##### ##### ###
# # # # # # # # # # # # # # #
#############################