#############################
# #         #               #
# # # ### ### ### # # ### ###
#       #   #   #           #
# ##### ###T### # ### # # ###
# #     #  E  #       # #   #
# # # # # # # # ### # # # ###
#     #   #  S  # # #     # #
# ####### ### # # ##### #####
# # # # # # # # # # # # # # #
#############################