##############################
# # # #      E# #   # # 0 # ##
# ### # #7# ####### # # ### ##
#     S # #   35  #   #     ##
# # ##### # # # # # # # # ####
#   #   #   #               ##
# ###4### # ##### ##### # ####
#2          # # # T       # ##
# # #1# ##### ##### # ### # ##
#   #     # # #   #   #    6##
##### ### # ### # ##### ######
# # # # # # # # # # # # # # ##
##############################