##############################
# #         #       #   #   ##
# # ##### # # ### ### ### # ##
#   #   #S        #   #  1  ##
##### ##### ### ### # ### # ##
#       E # #       #   # # ##
####### ##### ### ####### ####
# #       #     #      4    ##
####### ### ######### # # ####
#     # #       # #   #     ##
# # # # # ####### # # # # # ##
#     #     # #     # #     ##
#0# # # ### # ### ##### ### ##
# T # 32  # # # # #   # # # ##
##############################
##############################