##############################
#6 7      # #     4         ##
# ### # # # # # ### #2#E# #0##
#   T 3         #   #     # ##
# #5# # # # #1### # #S##### ##
# # # # # # # # # # # # # # ##
##############################