###############################
#                      ##T  # #
#   #          5   S  #   #  ##
#  ##     #     #  #7##  ##  ##
#    #  ###2    ####  #    ## #
###  6# ## #     #  #      #3 #
##  ## 4  #        ##       ###
# ## #  #         ##        ###
#  #  ###               1#   ##
#      ##             E  ##   #
#0     #               ####   #
##     #    8    ##   ####### #
#####   #   #  ##### ######## #
###############################