###############################
#         #     # # #     #   #
### ### # # ### ### ##### #####
# #   #   # # # #   #2        #
### # ##### # #S# ### # #######
# #     #  T        # # # # # #
### ##### ### # #0# # # # #####
# #       # #         #   #   #
### ##### # # # ### ### # #####
# #   #           #   #   #1  #
### ### ### # ###E# # # # #####
# # # # # # # # # # # # # # # #
###############################