###############################
# #   1 E0  #      S#         #
#2# ### # # # #3###T### # # ###
# #   #     #   # # # # # #   #
###############################
###############################