###############################
#  1  #   #4  #      S        #
##### # # # # ### # # # # # ###
# #       #       # #         #
# # # # # # #T# ####### ###5###
#    6# # # #     #  2 E 03 # #
###############################
###############################