###############################
#       #   #   # # #   #4# # #
# ###E# ##### # # # # ### # ###
#0#        2# #  T# #     S # #
#####5##### # # ### # #########
#           #  1#   #      3  #
# # # # #7# # # # #6### # # ###
# # # # # # # # # # # # # # # #
###############################