################################
###    ########## #####   ###  #
##       #######   #      ##   #
#        #######  #       ###  #
#     # # ## ###  ##      ##   #
##    ###    T##  #   ##      ##
##  ####    ##  #### #  #     ##
#  ####     #   ###   # ##   ###
#   ##     2   S ## ####    ####
#  ###       # E###  ###     ###
#    #       ####### ##1     ###
##    ##      ###### #    0#####
#######        #####       #####
################################