################################
##E#0#    ##     #####   3 #####
#  1  ####### S 2####5  #T 4####
# ### #######    ####  ####   ##
##   ######### ###### # ###    #
# # ###########    ###  ##  # ##
################################