################################
## #  ## E       #  ##   #     #
#  #      #     3    #  #T##76 #
#  ##   ### ##  8    ## # ##   #
#  5  ###  ### 4  2#### #1  #  #
# 0   ###S  ##      ## #   #####
##   ####        #  #   # #### #
################################