################################
#   #   # #  2  T     #       ##
### ### # # # #S# # # ### # # ##
# # #  0          # # 3     # ##
# ########### ### # ### ### # ##
# # #     #    E#   #     1   ##
# # ##### # # ### # # # # # # ##
# # # # # # # # # # # # # # # ##
################################