#################################
#   #     #         #         # #
# # ### ### # # ##### # # # #####
#     #E  #   #   #   #       # #
### ### # # # # ##### ###########
#   # # #   #   #     # #   #   #
# ##### # # ####### # # #3### ###
#   # # S1#   #     #       #2# #
# ##### ####### ### # ##### # ###
#   #     #0        #      T    #
# ##### # # # # # ### # # # # ###
# # # # # # # # # # # # # # # # #
#################################