#################################
# # # #0    #     #   #     # # #
### # # # # # # ### ### # # # ###
# 5   #       #   #   #       # #
# ### # # #S### ### ##### # # ###
#   # #           #E  #     3   #
# ### ##### # #####4### # # # ###
# #   #       #   #   #T        #
# #####1# ### # ### # ### ### ###
#   # # # #   # #   2 # # #   # #
#################################
#################################