#################################
#    T   2        1E#           #
# # # # # # ##### ### # # # # ###
# #S#       # #   #   # #0#   # #
#################################
#################################