#################################
# #         # T #     #      3  #
##### # # # # # # # # ####### ###
#     E   # #     #  1# S       #
### ##### # ### # ### # # # #####
# #     # #         # 0 #   #2  #
#################################
#################################