#################################
#             ##    2T##1# ###  #
#     0  S                  #   #
#  ### #  #  # # ##       # #   #
##  ### # ### # ####     # #   ##
## # ###        #####   ##     ##
#3  # #### #     ###      #   ###
#     #######    E    ## ###   ##
# #  ########  ###   ######   ###
#################################