##################################
# #2              1   #    S#   ##
# ### # # #T# # # # # # # ### # ##
# # # 3 # #54        0   E  #   ##
##################################
##################################