##################################
#E0   #     #       # # 2   # S ##
# # # # # # ##### # ##### ##### ##
#   #           # #   #   #     ##
# # ### #T# ######### ####### # ##
#1#   # #     #   # #   #       ##
# ##### # # # # ### ### # # # # ##
#   #   #   #       #      3  # ##
# # # # # # # # # # ### # ### ####
# # # # # # # # # # # # # # # # ##
##################################