###################################
# # #               #   # # T # # #
### # ##### # # # # ### # # # #####
# #           #     # #   #   # # #
##### ######### # ######### #E#####
#   #   #   #   # #   #   # #   # #
##### ####### # ### # ### # # # ###
#   #   #       # # #       #     #
### # # # ######### # ### # # # ###
# #         #           # #   #   #
# ##### ### # # # ####### ### #####
# #     #                         #
### # ### # ### # # # # # # ### ###
# #     #S  # #   #     # #     # #
###################################
###################################