###################################
#   # #    E  # #  T    #       # #
####### # #4### # # # # ### # #####
#     # 3              2        # #
### ### ### ##### ### # # # # #####
#         # #       #5  #    7    #
# # ######### # # # ####### # # ###
#   #   #   # # #     #   #   #   #
##### # # #6### #S#1#0### #########
# # #               # # #   #     #
##### # # # # ### ### # ### #######
# # # # # # # # # # # # # # # # # #
###################################