###################################
#    # 12     #########   #########
#####   T   ES0 #######     #######
#####           #######     ####  #
###################################