###################################
#   S 1 0T  #       # E     #   # #
##### # # # # #3### # # # # # # ###
# # # #     #             # #  2# #
###################################
###################################