###################################
#5  # #0                #   # S # #
# ### # ### # # # # # ##### # # ###
#   #E  #     # #   T13       # 4 #
# # # ### # #6# ### # # #####2# ###
# # # # # # # # # # # # # # # # # #
###################################