###################################
###     ######       # 1   ## S # #
###     ######2     ###         ###
##     ########   #####         ###
##     ##  ##### ###E     0  T#####
####  #    ##    ###         #### #
####   ###  #  ##  ## #       ##  #
###    ###      # #   ##  #  #### #
##    #####      ##   ##  #########
###################################