###################################
#       #         # E         #   #
### ### ##### # # # ##### # # # ###
#    S    # #           #   #     #
# ### ### ### # # # # # # #########
#           # #   #   #   #   # # #
# ######### # # # # # # # # # #####
# #     T       #         # # # # #
# # ### # ### ##### ### # ### # ###
# # # # # # # # # # # # # # # # # #
###################################