####################################
#   #     #   #     #             ##
# # #####T### # # ### # ### # # # ##
# # #0# # 3     #   #   # #       ##
###E# ### # # # # # # ##### ### ####
# #     # #             #       # ##
##### ######### # # # ### # # # ####
#   #     # # # #   5     # #6#   ##
# #####1# # #S##### ### # ### # ####
#2  #       # 4       # #         ##
##### ##### # # ### # # # # # # # ##
# # # # # # # # # # # # # # # # # ##
####################################