####################################
# #   #    3#  ES2 1  # #     0   ##
#5# ###T# # # # ##### # # # # # # ##
# # # #             # #  6# # 4   ##
####################################
####################################