#####################################
# # # #   #                     # # #
# ####### ##### ### # # # # ##### ###
#   #       #         #       # E # #
# ####### # ##### ### # # # ### # ###
#       #T        #     # #   # #   #
### # # # ######### ##### # # ### ###
# 0       S #   #   # #   # #     # #
# # # # # ### ##### # # # ### ### ###
# # # # # # # # # #   # #   # # #   #
#####################################
#####################################