#####################################
#       #   # #   #   # # # #       #
# # # # # # # # ### # ######### #####
#   # # #   #   # #   # #   # # #   #
# # # # # ### ### # # # ####### # ###
# #       # # # # # #   #           #
# # ### # ### ### # #E### # ### #####
#0#       # # #     #   # # # #     #
##### # # # ##### # # # ### #########
#     # #       # # # # #         # #
# ##### # ##### # # # # # ####### ###
#         # #   # #         #     # #
# # ### ####### # # # # ### # # # ###
#   # # # #   # #       # # #   # # #
# ######### # # # # # ### ### # #####
#       #         #       # # # #   #
######### ### # # # ##### # # # # ###
# #   #  T#       #    S    # # #1# #
# # # ##### ### # ####### # # # # ###
# # # # # # # # # # # # # # # # # # #
#####################################