#####################################
#  ###     ###   ###     #####  ##  #
#    ##T  ###     ##      ### # ##  #
#    ##   ##       #   E   #  #     #
#   ##    #  #    ##      #   #    ##
#    ##     ##   ####      ##  #  ###
#  #        ###  #####       ###  ###
#####    #  ###### ###    #         #
####    ## ######   ##   ##         #
#####       ###   #     ###         #
#####      # #   ## #   # #     # # #
####      #        # ###   # ## ### #
####     ###      # # ###   ### ##  #
######    ###    ##  # ##     #  ## #
#######    ##   #      ##    # #   ##
######         #      #       ##    #
##### ###   # #      # #        ##  #
#     # #  # ####    ##           # #
#           # ###       ##  ##    # #
#    #S###   #  ##    ### ##  ###  ##
#  ############       ###     ##### #
#####################################