#####################################
## #         # #   ####4  #  ##2   ##
#10    #   E  #      #3# ## T 5 S   #
#     ##  ## #       #  #     #     #
#####################################