#####################################
###   #  3 #     ######       ##E   #
### ## #      #   ####        #     #
## ##  #     ##   ##                #
# #   ##     #       1      0     S #
#    ##               #T  ## #      #
## # # 2    ##5      ##########     #
# ##       #  #    ##############   #
#  #  #  ## 4####  #######  ######  #
# ###############  #######    ####  #
#####################################