#######################################
#         S   #3   4      #  E    0   #
# # # # # # # # # ##### # # ### #######
# # 2 # # # # #   # #     1T  # #   # #
#######################################
#######################################