#######################################
##3       #####       ##  ###       ###
#           ####      #   ###     ### #
#    4    T ###         ## ### 2  ### #
#  ###      ###     0  S #  ##  #   # #
#1###        E 5    ##    ##   ####   #
# ###         #### #### ####   ########
#######################################