#######################################
#             #         # # #     # # #
# # # # # # # # # # # ### # ####### ###
# #   # #       #   #     S      T  E #
# # ### ### # ### ##### # # # # # # ###
# # #   #       #   # # # #   #       #
### ### # ### # # # # # ####### # # ###
# # # # # # # # # # # # # # # # # # # #
#######################################