#######################################
##       # ###  ###        ##  #####  #
#   #S        ####               1##  #
# ###   #    ###### ##            # 2 #
### # #E##   ###### ####   ##   ##    #
##   ##     #######  #####  ### #     #
## ##  #     ##     ########   #0     #
###  ##      ##  # #########       T ##
###  ####   ##   ####      #  ### ### #
#########       #####      ##  #  ### #
#######################################