########################################
#     #       #   #   #         #   # ##
########### ### ####### # # # ### # # ##
# #   #   # #       #S# #   #     #   ##
####### ### # # ### # # # # # # ### ####
# #     # #   # # # #     # # # # #   ##
# # ### # ### ##### ### # ##### ### ####
# #       #   #    T  #   # 1       # ##
##### # # ### ### # # ##### # ##########
#   # #    0      #   # #   #   #     ##
# ### # #E####### # ### # ### ### ######
#           # # #   # #       #   #   ##
### ### # # # ### ### ####### ### # ####
# #     # # #   # # #       # # #   # ##
# # ##### # # # # ### # ### # # ##### ##
#   # #     # #   # #   #   #       # ##
######### # ####### # # ##### # # ### ##
#   #                   #     #       ##
### ### ####### ### # # ##### # # # ####
#   #         #       #   # # #     # ##
# # ####### # # ### ### # # # # # # # ##
# # #   #   #   #   # # #     #   #   ##
########################################
########################################