########################################
#2# #       # E S   #             # # ##
# # # # # # # # # # # # # # ###0# ######
# # # #        3      #         1 T   ##
# ### ### ### # ##### # # # ### ### ####
# # # # # # # # # # # # # # # # # # # ##
########################################