########################################
##       ####  ##  ###  #  # ###     # #
##        ##    #   ##  #     # S    # #
####2     #3       ###  #     #       ##
####            ## ##### #  ###    0 1 #
####       #    T# ##### #####     #####
###      ###  E#    ###   ###     ######
####     ###   ##    ##   #        #####
########################################