#########################################
# #       #   #     # #     # # #   #   #
# #T# # ###S# # # ### # ####### # #######
#     # # #   # #     #     #   #       #
####### # # # # ### # ######### # # # ###
# #       #     # #   #   # #     #     #
### # # # # ### # # # ##### # ##### #####
#   #   #         # # #     #     #   # #
# ##### # # ### # # ##### ### # # ### ###
#   #     # # # #   # #       # #   #   #
# # # # # # # ### # ### # ### # # # #####
#     #   #   # #   #         #   #     #
##### ### # ####### ##### ### # # ### ###
# # #           E #         # # # # #   #
# ##### ### ##### # # ### ### # # #######
#   # #     # #   # #     # # # # # # # #
#########################################
#########################################