#########################################
#     #     # # #       # #           # #
# # # # ### ##### ##### ### ### #########
# # #       # # # # #        T        # #
# ### # ### # ##### ### # ##### # # # ###
# #       # #   #     # #             # #
# ########### ##### # ### # # ### ### ###
# # #     #       #         #     # # # #
# # # # # # ##### # ### # # # # # # #####
# # #   # #       #   #     #     # #   #
####### ###E# ##### ##### ###############
#       #   #           # #   #   #   # #
# # ### # ### # ### ### # ##### # #######
#   # #       # #       # #           # #
# # ##### # ### ### # # # # ### #########
# # #     #   #       # #   #     # # # #
# ##### # # # # ### # # # ### ### # #####
#     #  S    #           #         #   #
##### ### # ##### ####### # ####### #####
#       #     #   # #   # #   #   #   # #
#########################################
#########################################