#########################################
# # # #         #     #       # #   # # #
### ### # ##### # ########### ### # # ###
# # T # # # # #       #     #   # # #   #
# # # ### ### # ##### ### # # #0# # #####
#   #   # # # # #   # # #   #     # #   #
# # ####### # # # ### # # ### # # # #####
#   # #         # #     #   #       #   #
# # ### # # ###########E### ### #########
# #   # #         #   #   # # # S     # #
### # # # # ### # ### ### # ##### # # ###
#       #     #     1 #   #   #   #     #
##### ### # # ##### ### # ### # ##### ###
#       # # # # # #           #   #     #
# ### ##### # ##### ### ### ##### # # ###
# #   #   #         #         #   # #   #
# # # # ##### # # # # # # # #############
# #   # #   # # #   # #           # # # #
##### # # # ### # ### ### ### ### ### ###
# # #     #   #   #                   # #
# ### ### # ####### ### ##### # ### # ###
# # # # # # # # # # # # # # # # # # # # #
#########################################