#########################################
### 5###  ##############S  T 0      1####
# 4 3###    #######  ###          ##E2###
#           #####    #  # ##   #   # ## #
#########################################