#########################################
#      T  # S  0  #   #      2# #   1   #
###E# ### #4# ### # # # # # # # # # # ###
#5    #3# # # #   #   #   #   #     #   #
#########################################
#########################################