#########################################
#                   # # #           #   #
#0##### # # # # # # # # # ### # ### #####
# #     #   S   #      T    # #   # #   #
# # #####E### #1####### # # ##### # # ###
# # # # # # # # # # # # # # # # # # # # #
#########################################