#####
#T E#
# # #
# 1##
#####
# 0##
#   #
#  S#
#   #
#####
# 2 #
#  ##
#####