#####
# E #
# ###
#1  #
# ###
#ST #
# ###
# 2 #
# ###
#43 #
# ###
# 0 #
# ###
#   #
# ###
# # #
#####