#####
#T1 #
#S###
#   #
# ###
#   #
# ###
#   #
# ###
#   #
# ###
#   #
#####
#E  #
# ###
#   #
#0###
#   #
# ###
# # #
#####