#####
#   #
#####
# # #
#0###
#T# #
# ###
#   #
# ###
#E  #
# ###
#   #
#####
#   #
# ###
#  1#
#####
#  2#
#S###
#   #
# ###
# # #
#####