#####
# 2 #
#####
# 3 #
#####
# 7 #
#1###
#   #
# ###
#0  #
#S###
#   #
#T###
#E  #
#5###
#   #
# ###
# # #
#####
#6  #
#####
#4  #
#####
# # #
#####