#####
#T E#
# # #
#  ##
## ##
#S  #
#   #
#####