##########################################
# #   #       #         # # 0 #         ##
# # ### ### # # # # # ##### ### # # # ####
#   #       #   #   # #     #E      # # ##
### ###S### ### ####### # # ### # # # ####
# #     # T # #     # #     # #   #1#   ##
# # # # # # # # # # # # # ### # # # # # ##
# # #     #     #   #   #       # #   # ##
# ######### # ### # # # # ### # # # ### ##
# # # # #     #   #   # #         # # # ##
##########################################
##########################################