##########################################
#             # S   # # # # # #         ##
# # ####### # # # # # # # # # # # ### # ##
#       #   #T  # #   # # #   E #   #   ##
##### # # # # # # ### ### # # # # ### ####
#   # #           #   #  3  #   #       ##
# # ###2# # # ##### ### # # ########### ##
# # # #     #               #     # # # ##
# # ### ### #############4# # # #####1# ##
#     # # #     #   #   # # #   # # #   ##
# ### # # ################### # # # # ####
#       #   # # #   #  0#               ##
# # # # # ### ### ### ### ### ### ### # ##
# # # # # # # # # # # # # # # # # # # # ##
##########################################