##########################################
#     T # #     #       #     #   #     ##
### ### ###1# # # # # ### # # # # ### # ##
#   # #   # # #   # #     # #     #     ##
# ##### ####### ####### ### ### ### # # ##
# # #       #   # #       # #           ##
##### ### # # ######### # ##### ##########
#     #     # # # # #         #     #   ##
#0# # ######### # # ### # # # # # # ### ##
# # # #     # # # #   # # # # # #     # ##
### # # # ##### ### # ### # # # ##########
#       #   # #       #   # #           ##
# ######### # # # # # ##### # ##### ### ##
#   # # # #S            #   # #       # ##
# ### ####### ##### ### # # ### # # ### ##
#     #   #       # #         # E #     ##
# ### ####### # # # ######### # # ### ####
# # #         # #       # #     #   #   ##
### ####### ### ### # # # # # # # # # ####
#   # #   # #     # # # #   #         # ##
####### # ### # ####### ### # # # # # ####
# # # # # # # # # # # # # # # # # # # # ##
##########################################