##########################################
#           # #   2 # #  1 3  4     # # ##
# # # # # # # # # # # ####### # # #E######
#   5        T    # #             # #   ##
### ##### # #S# # # ##### # # # # #0# # ##
# # # # # # # # # # # # # # # # # # # # ##
##########################################