##########################################
# #       # # #   E  1   0  #           ##
##### # # # # # # # # # ### # # ### # # ##
#   #   # #           #      T   2#     ##
### ### # # # # ####### ##### # # #S# ####
# # #   # #   # #         # # # # # # # ##
##########################################
##########################################