##########################################
# #  T    #   #     4    2#   #   #  S# ##
# # # # ### # ### # # ### ####### # # # ##
#     #   #1  # #                   # 5 ##
### # # ### # # # # # #######3### # # ####
# 0         #   #           #     #E# # ##
### # # # ####### # # # # # # # ### ######
# # # # # # # # # # # # # # # # # # # # ##
##########################################