##########################################
# 1#     #     ## 2     ###   8  # # ### #
#   #   #    #  #   ## #####     ###  #  #
#    ### 3 # ##  ###########S T  ###  #  #
##  #   ####  # ########6 #          # # #
####E    ##   # #  #7 ##   ##         #  #
###       #    #5      #   #     #    ## #
###4 # #   ## ###        #      ##    0###
##  #######  ####    ## ###     ##### ####
##########################################