######
#  #E#
#    #
#   ##
#S0  #
# # ##
# # T#
#### #
####1#
######
###  #
#    #
# 2  #
######