######
#  # #
#    #
#   ##
# 0  #
# # ##
# # T#
#### #
####1#
######
### S#
#E   #
# 2  #
##  ##
# # ##
# # ##
######