######
#  # #
#    #
#   ##
#    #
# # ##
# #  #
# #  #
#    #
#    #
######
### S#
#  # #
# 0 T#
#    #
#   ##
#   ##
# # ##
# #E##
# ####
######