######
#   ##
# ####
#4# ##
### ##
#S  ##
# ####
# # ##
#3# ##
#   ##
### ##
# # ##
# #1##
#   ##
# ####
# ET##
###5##
#6  ##
#0# ##
#7  ##
#2# ##
# # ##
######
######