######
# E ##
# #T##
#   ##
# #2##
#   ##
# ####
#   ##
# ####
#   ##
#S# ##
#   ##
# # ##
# 0 ##
# # ##
#  1##
# # ##
# 4 ##
# #3##
# # ##
### ##
#   ##
### ##
# # ##
######