######
#2# ##
### ##
#   ##
######
#   ##
# # ##
#   ##
######
#   ##
# # ##
# # ##
# # ##
#E# ##
# ####
#   ##
#T# ##
#31 ##
# ####
#0S ##
### ##
#   ##
# ####
#   ##
######
######