######
#   ##
# # ##
#   ##
# # ##
#   ##
### ##
#  S##
# # ##
#   ##
# # ##
#   ##
### ##
#   ##
# # ##
#  1##
### ##
# T ##
# ####
# 0 ##
### ##
#   ##
# ####
# E ##
######
# # ##
######