#######
# #1  #
# # ###
#   # #
#0# ###
# #TE #
# #####
#     #
#S#####
#     #
#######
#######