#######
# # # #
# # ###
# TE# #
### ###
# #   #
# #0###
# # # #
# # ###
#   1 #
# #####
# #2  #
# #S###
# # # #
#######