#######
#4# 6 #
# # ###
# E   #
### ###
#   # #
# # ###
# 5 # #
###3###
#     #
# #####
#1#   #
# # ###
#   # #
# #S###
# 02  #
#T#####
# # # #
#######