#######
# 2 4 #
#S#0###
#   1 #
#7#####
# 5 # #
# #####
#T  3 #
# #####
# #   #
# # ###
#  8# #
# #####
#6# # #
# #####
#   # #
#E# ###
# # # #
#######
#######