#######
# #   #
# # ###
#   # #
# #####
#   # #
# # ###
#     #
#1#####
#     #
#0# ###
#   # #
# #####
#     #
###S###
#   E #
#######
#2  # #
# #T###
# #3# #
#######