#######
# #   #
# # ###
#     #
# # ###
#     #
### ###
#     #
### ###
#   # #
# # ###
#0#   #
### ###
#  S  #
#T#2###
#   # #
### ###
#  1  #
# # ###
#   # #
# #E###
#   # #
# # ###
# # # #
#######
#######