#######
#E    #
#S#T###
# # # #
#######