#######
#  T  #
# # ###
#S0 E #
# #1###
#     #
# # ###
#   # #
#######
#######