########
#     ##
# # ####
# #   ##
# # # ##
# # # ##
# #S# ##
# T E ##
# ### ##
#     ##
### # ##
# # # ##
########