########
# #   ##
# #T# ##
#     ##
# # # ##
#S    ##
#3# #1##
#     ##
#E######
# #  2##
# #0# ##
# #   ##
########
########