########
#     ##
##### ##
#   # ##
#T# # ##
# S # ##
# # ####
#     ##
# # # ##
#     ##
# ### ##
# # # ##
# # # ##
#   E ##
### # ##
# # # ##
########