########
# # # ##
# # # ##
#     ##
### # ##
# E # ##
# # #T##
#     ##
# ######
#S  1 ##
# # # ##
#     ##
###2# ##
# # # ##
### # ##
# #   ##
# #0# ##
# #   ##
##### ##
#     ##
# ######
# # # ##
########