########
#   #T #
# #### #
#      #
# # ####
#   # ##
# ### ##
# #   ##
# # # ##
#     ##
###S# ##
#   # ##
# # # ##
# # # ##
# # # ##
# #   ##
# # # ##
#     ##
#E# # ##
# # # ##
# # # ##
#   # ##
########
########