########
#T# 0S##
#   #E##
# # # ##
########