########
#T 1#S #
#   #  #
##  #0 #
#E ##  #
########