########
#T  03##
# # #E##
#  42S##
# # #1##
# # # ##
########