########
# 1  E##
# # # ##
#   S2##
### # ##
# 0 # ##
# # # ##
#    T##
########
########