########
# E # ##
# # # ##
#     ##
# ### ##
#2 S01##
# # #3##
# T   ##
# # # ##
# # # ##
########