#########
# #S#   #
# # # ###
#  3 0  #
# # # ###
#   #   #
# # # ###
# # 2   #
###T# ###
#E#   1 #
#   #####
#########