#########
#     S #
#3#5# ###
#  0    #
# # #####
#       #
# #2#####
#T#   E #
#4#######
# #6#1  #
### #7###
# # # # #
#########