#########
#       #
###T# ###
#  S  # #
# # # ###
# # #   #
# #0# ###
#     # #
# # # ###
#   # E #
# # #1###
#       #
### # ###
# # # # #
#########