#########
#       #
# # # ###
# # # # #
# # # ###
# # # S #
# # #E###
# #     #
# # # ###
#       #
# # # ###
# #0#   #
### #####
#     # #
# # # ###
# #     #
# # # ###
#    T# #
# ### ###
# # # # #
#########