#########
#     # #
# #E#####
#     # #
# # # ###
# # S   #
# # # ###
# #     #
# # #####
# #   # #
# # #####
#    0  #
# # # ###
#   1 2 #
#########
# #     #
# ### ###
#   #   #
# # # ###
# # #T3 #
# ### ###
# # # # #
#########