#########
#2# E   #
### #####
# 0 #   #
# #5#####
#  1    #
### # ###
#    S# #
#3### ###
#  64   #
### # ###
#  T    #
# # # ###
#       #
### # ###
#   # # #
### # ###
#     # #
# # #####
# # #   #
### #####
#   # # #
#########
#########