#########
# # # S #
# # # ###
# #   4 #
### # ###
#     T #
# ### ###
#       #
### #####
# #     #
# #######
#2  #   #
# # # ###
#E  # # #
# # # ###
# # 01  #
# # # ###
#   #   #
##### ###
# #     #
##### ###
#3  #   #
# # # ###
# # # # #
#########