#########
#   S  ##
#     ###
##     ##
#E #  T##
#########