#########
#0T   # #
#1# # ###
#       #
# #S# ###
# #E#   #
#########
#########