#########
#2     E#
#  #  # #
#  #T## #
#  ##   #
#S    0 #
#       #
#  1    #
#########