##########
#T    0 ##
# # ###E##
# 2 # # ##
#S##### ##
# #     ##
# # ### ##
#     1 ##
# # ### ##
#       ##
##########
##########