##########
#   #   ##
#2########
#   T 6 ##
#3# ### ##
#   #   ##
### # # ##
#E     S##
#4# #5####
#    0# ##
#1# ### ##
# # # # ##
##########