##########
#   0 # ##
# ### # ##
# # #   ##
### # ####
#       ##
# # ### ##
#       ##
# ########
#     # ##
####### ##
#  T   2##
# ### ####
# S   #E##
# # # #1##
# # #   ##
##########