##########
# #     ##
### ### ##
#E    # ##
# ### # ##
#       ##
# ##### ##
#     3 ##
# #1# # ##
#       ##
### ### ##
#  0    ##
# # # # ##
# T2#   ##
##### # ##
#   S # ##
##########
##########