##########
#   # 3 ##
# # # ####
#  50T  ##
# # # #2##
# #  4  ##
# # ### ##
# #   #E##
####### ##
#       ##
### # # ##
# #     ##
# ### # ##
# #   # ##
# ### # ##
#  1    ##
### # #S##
# # # # ##
##########