##########
#    T  ##
#1### # ##
#  3# # ##
### # # ##
# #    2##
# # # # ##
#       ##
# # # ####
# # # # ##
# # # ####
#E#  S  ##
##### ####
# #     ##
# # # # ##
#     4 ##
### # # ##
# # 0   ##
##########
##########