##########
# #   # ##
# # ######
#     # ##
# # ### ##
# #     ##
# # # ####
#   T   ##
# # # # ##
# # #   ##
# # # # ##
#       ##
##### ####
#   E   ##
# # # ####
# #S    ##
# # ### ##
#   #   ##
####### ##
#   # # ##
##########
##########