##########
#   #   ##
### # # ##
# 0  3 E##
##########
#   # # ##
### # # ##
# T   # ##
# # # # ##
#     # ##
# # ######
#       ##
# # ### ##
# #     ##
# # # ####
# #  S4 ##
### # ####
#2#     ##
# ### ####
#   #   ##
# # ######
# 1 #  5##
##########
##########