##########
#       ##
# ########
#     # ##
# ### ####
#   #   ##
# # ######
#S      ##
### # ####
#T   1#2##
# # # # ##
#       ##
####### ##
# #0# # ##
# ### # ##
#       ##
# # ### ##
#       ##
# ### # ##
# #E  # ##
##### # ##
#     # ##
# ### # ##
# # # # ##
##########