##########
#T    # ##
#3### # ##
# # 1   ##
### # ####
#     0 ##
### # #S##
# # 2E  ##
##########
##########