###########
#E      # #
# ### #####
# T     1 #
# # # #####
#       0 #
### # #####
#   #     #
# ### #####
# # # #   #
# # # # ###
# #  S#   #
# ### # ###
# # # # # #
###########