###########
# #     # #
# #S# # ###
#         #
# # # # ###
#E 3#   # #
# ### #####
#  0# # # #
### # # ###
#      1# #
# # ### ###
#         #
###T###2###
#   # # # #
###########
###########