###########
#         #
# ### # ###
#     # # #
# # # # ###
#   #     #
# # ### ###
#T#   #   #
# #S#######
#         #
# ### # ###
# # #   # #
# ### # ###
#   E # # #
# # # #####
# # # # # #
###########