###########
#S# #   # #
# # # # ###
# #       #
# # # #####
#     # # #
### #T# ###
#   #     #
### ### ###
#     #   #
### ### ###
#   #  E  #
# ### # ###
# #   # # #
### # #####
#   #   # #
##       ##
###########