###########
# #   42  #
#####0#####
# # #     #
#T# # # ###
#  5#     #
##### # ###
# # #6  # #
# #########
# # #     #
# # # # ###
#      3  #
# ##### ###
#ES       #
# # #1# ###
#         #
##### # ###
# #   # # #
# # ### ###
#       # #
###########
###########