###########
#     #   #
# # # #####
#T#       #
# # ### ###
#         #
### # #####
# #   # # #
# ### # ###
#         #
# #########
#E    #   #
##### # ###
# # # #   #
##### # ###
#   #   # #
# # # # ###
#   #S    #
# ### #####
#   #     #
# #########
# # # # # #
###########