###########
#       # #
### #######
#4# # # # #
# # # #####
#   6     #
# # # # ###
#     3   #
# ###S# ###
#   #     #
### ###7###
# 0 #   # #
# # ###5###
# #   2 E #
# # ### ###
#         #
### # # ###
#   # #   #
# #########
#    T 1  #
# # ### ###
# # #   # #
###########
###########