###########
# # 1     #
# ##### ###
# #       #
# ###S# ###
#0 T  #   #
# ### #####
#         #
# ### # ###
# # # # # #
# ##### ###
# #   #   #
# # # # ###
# #       #
# # ### ###
# # #   # #
##### #####
#         #
# ### # ###
# #       #
# # ### ###
#E  #     #
##### #####
# #   #   #
###########
###########