###########
# # #     #
# # # #####
#3  #   # #
# ##### ###
# # 0     #
# # # #####
#   # #   #
# ##### ###
#   # #   #
### # # ###
#   E     #
# ### #####
# #       #
# ##### ###
#    42 # #
# ##### ###
#     #6  #
# # ###5###
#   T     #
# # ### ###
#       # #
# # #######
#  S1 # # #
# # # #####
# # # # # #
###########