###########
#TE3 S 0  #
###4#1#2###
# # # # # #
###########