###########
#   S  ## #
#   0####1#
##     #  #
#E # #T   #
###########