###########
# #  E S# #
#T# #3#0###
# # 1   # #
#4# ###6###
# # 25# 7 #
###########
###########