###########
#     # T #
# #S# # ###
# 23E   # #
#0# # #####
#  4#1  # #
# # ### ###
# # # # # #
###########