############
# 3 #   # ##
# # #####0##
# #   #   ##
# # ###E####
# #   #   ##
##### ######
#         ##
### # # # ##
# # #   # ##
# ### # # ##
#   #     ##
#5#S# # # ##
#   1     ##
###4##### ##
#    2  #T##
# ####### ##
# # # # # ##
############