############
#T        ##
# ### # ####
# #6    S ##
####### ####
# # #     ##
# # ##### ##
#   #   # ##
# # #4# ####
#     #E# ##
##### ### ##
#  5      ##
# # #1### ##
#         ##
####### #0##
#  3# 2   ##
############
############