############
#   #   # ##
# ##### # ##
#       #4##
# #0# # # ##
#     # # ##
# ###S### ##
# #       ##
# # ### # ##
# #       ##
#2### # ####
#3# #   # ##
### # ######
# #   #   ##
### # ### ##
# #   #T  ##
# # ##### ##
#     E  1##
# # ### # ##
# # # # # ##
############