############
# #       ##
# # # # # ##
#   #    0##
# ### # # ##
#       # ##
#3### # ####
#2#       ##
##### # # ##
#  E  # # ##
# ##### # ##
# T #     ##
# ### #S# ##
#       # ##
### #1# # ##
# # # # # ##
############