############
#         ##
# # ##### ##
#   # #   ##
# ### # ####
# # #     ##
# # #1# # ##
# # #  S2 ##
### # ### ##
# # E # # ##
##### # # ##
# #    0  ##
# ### # # ##
#       # ##
# ### # # ##
#   #   # ##
############
# #T 3  # ##
### # ######
# #       ##
# ### # # ##
#         ##
# # ##### ##
#   # # # ##
# ##### # ##
# # # # # ##
############