############
# # # 4   ##
###T# ######
# #0#   2 ##
# ### # # ##
#S    # # ##
#6# # # # ##
# #       ##
# ### # # ##
#       # ##
# # # # ####
#   #   # ##
#5##### # ##
#       #1##
# # # ######
#     #   ##
### #E######
#         ##
### ##### ##
# # #     ##
### ### ####
#  3#     ##
# # # # ####
# # # # # ##
############