############
#   # #   ##
##### # # ##
#         ##
##### # ####
# # #   1 ##
##### # # ##
#   # # # ##
# # ### # ##
#     # # ##
####### ####
#     #   ##
##### # ####
# #       ##
### #0### ##
#E     2  ##
# #T# # # ##
#   S   # ##
# # ### # ##
# #   # # ##
############
############