############
#   # #   ##
# # ##### ##
#   #T  # ##
# ### # # ##
#   # # # ##
# ### ######
#         ##
### # ######
#     1 E ##
# ####### ##
# #   S # ##
# # # # # ##
# # #   # ##
# # # ######
# #   #   ##
# # # # # ##
#   # #   ##
# # # ### ##
#   #   # ##
### # # #0##
#   #   # ##
# ### # ####
# # #     ##
#     ######
############