############
#  T  #   ##
# # # # ####
#     # # ##
# # # ######
# #     # ##
# # # # ####
# # #     ##
# ### ### ##
# S     # ##
###0# ### ##
#   #     ##
# # # ### ##
#         ##
# # ### # ##
#   # # # ##
### # # # ##
# #       ##
# # # # # ##
#   # # # ##
###1# # # ##
#    E# # ##
############
############