#############
#   #0#   E #
# # #4# #####
#       #   #
#5# #S# # ###
#     # #   #
### ### #####
#   2   #   #
# ##### # ###
# #   #     #
# ### #3# ###
#   # #T  # #
####### #####
#       #   #
# # # # # ###
#     # #   #
# ##### # ###
# # #1# #   #
#############
#############