#############
#       #   #
# # # # # ###
# #         #
# ##### # ###
# #       # #
# # ### #####
# # # # #   #
# # ##### ###
# #       # #
# # # # #####
# #0E #   T #
#S# # ### ###
#   1 #     #
# # # ### ###
#     #   # #
#############
#############