#############
#         T #
### ### # ###
# #     #   #
# # # ### ###
#   1S  #3# #
####### #####
# 2   7 #   #
# ##### #####
# # # #   E #
# #6### # ###
#     # # # #
### # #######
#     # 0   #
# #8### #####
# 5 #     4 #
# ##### # ###
# # # # # # #
#############