#############
# #       # #
### #E#1#####
# #         #
##### # # ###
#     # # # #
# ### ###0###
#     #     #
# #2# # # ###
#   # #   # #
### ### # ###
#   # #   # #
# #####4# ###
#     # #   #
# # ##### ###
# #   # # # #
# # # ### ###
#       T   #
##### # #####
#     #     #
# ### # #####
#     # #   #
# # # # #####
# # #    3  #
# # ###S#####
# # # # # # #
#############