#############
# # # #     #
##### # #####
#   0   E   #
##### # # ###
# # #     # #
# # # # #####
# # #   # # #
# ##### # ###
# # #       #
# ### # # ###
# # # #     #
### # #T#####
# #4    S # #
# ### # #####
# # #     # #
# # # ### ###
# # #       #
#######2# ###
#   # #  5  #
# # # # # ###
#      3    #
# ### #######
#   # # # 1 #
#############
#############