#############
#1 E        #
# # # # # ###
# #S#T    # #
##### # # ###
# # #   0   #
# # # # # ###
#   # #     #
# # ##### ###
# # # # # # #
#############