##############
# # # # #   ##
### # #3# #E##
# # # #     ##
### # # # # ##
# #         ##
# # ### ######
#   # #    0##
###2# ### ####
# # 1     # ##
# # # # #S# ##
#       #T# ##
##############
##############