##############
#   5   #   ##
### ### ### ##
#   #       ##
#E# # #####S##
#  3  #     ##
### #T# # ####
#2# # # #   ##
###6# # ###0##
# #   #7  # ##
# ##### ### ##
#   1  4  # ##
# ### # # # ##
# # # #     ##
##############
##############