##############
#     E     ##
#T######### ##
#  S#       ##
# # # ########
# #         ##
####### # # ##
# 3 #  1# #2##
# # #0# # # ##
# #   # #   ##
##############
##############