##############
# # # # # # ##
### ##### # ##
# #    3  # ##
### ####### ##
# #S        ##
#2### ##### ##
#   # #   # ##
##### # # ####
# # #       ##
# ##### # # ##
#   #E  #0# ##
# # # # # # ##
#   #1#     ##
# ### # # # ##
#         # ##
# ### ### # ##
#     #   T ##
##############
##############