##############
# #       0 ##
### # # # # ##
#   T   #  S##
# # #2########
# #   # #   ##
# # # # # ####
#       #   ##
# # # # ######
#     E #   ##
# # # ### ####
#   # #     ##
# #1# ### ####
#   # #     ##
##### ### # ##
#         # ##
### # ### # ##
# # # # # # ##
##############