##############
#   # #     ##
# ####### # ##
#   #     2 ##
#3#0# ### # ##
#  T  # # # ##
# # # # # # ##
#   # #     ##
##### ##### ##
#     #     ##
##### ### # ##
#E# #     # ##
# ############
#     5 6   ##
# # # # # ####
# # #       ##
##### # # #S##
#     # #   ##
### # # ######
# # 1 # # 4 ##
######### # ##
#           ##
# # ##### # ##
# # # # # # ##
##############