##############
# #       # ##
#1###2########
# #  7   4  ##
# # # ########
#     # #   ##
# # # # ### ##
#   # #   # ##
# ### # # # ##
# #   #   # ##
# ### # #E####
# #         ##
### ### # # ##
# #     # # ##
### # ### # ##
#T# #     # ##
# ####### # ##
#  5  #     ##
# # # # # # ##
# # # #  S  ##
# # ### # ####
#           ##
##### # ######
# # 6 #0  3 ##
# # ### # # ##
# # # # # # ##
##############