##############
#   2   #   ##
#T### # ### ##
#   #  4    ##
### # #####1##
#        S  ##
#E# # ### ####
#0 3#   # # ##
##############
##############