##############
#  2        ##
# ### # # # ##
# E #S# #   ##
#T# ### ### ##
#   13# #   ##
# ##### # # ##
#   0 # #   ##
### # # # ####
# # # # # # ##
##############