###############
#   #     #   #
# ##### # #####
# # #   #     #
# # # #########
#   # # # # # #
#T# ### # #####
# #     #     #
# # # # ### ###
# # #     S   #
# ###E# ### ###
# #       #   #
# ### # # # ###
#           # #
# ### # # # ###
#       #     #
##### ### # ###
# # # # # # # #
###############