###############
#       #   # #
# # # # ### ###
#           # #
# ##### # #T###
#S      #7    #
# # ### #0# ###
#           # #
#2# ##### #####
#  3 58 #     #
### # # # # ###
#      1#4#E6 #
##### ### #####
# #     # # # #
###############
###############