###############
#  2     0 T  #
### ##### #####
#5   S      E #
### ##### #####
#         #   #
# # # # #######
# 6  1#3#   # #
# # ### # # ###
#   #       4 #
###############
###############