###############
# #   # #     #
# ### # # # ###
#         # # #
# # # # ###S###
# # #      E  #
##### # # #####
#   # # # # # #
# # # ### # ###
# #       #   #
# ### # #######
#     # # #   #
# ### # #######
#T    #     # #
### # ##### ###
# # #         #
###############
###############