###############
#   #5  #     #
# ### ### # ###
# # # # # # # #
### # # ### ###
#   # 4   #   #
### # ### # ###
#     #   3   #
##### ### #####
#   #   #     #
# # # # ### ###
#   2   # S0# #
# #1# ### # ###
#   #         #
# ### ###E#####
#     #   T   #
######### #####
#   # # # #   #
###############
###############