###############
###########  ##
###### #    ###
#  ##       ###
#       #  # ##
#      ###  # #
##  ######### #
##   # ###### #
#   #   ####  #
#  #    ##    #
# ###  ##     #
#    #  #    ##
##  # ##    ###
### ##      ###
###           #
##       # S  #
## E    # #  ##
####     #  ###
###   # T     #
###   ##      #
## ##         #
#  ### 0      #
# #####    ## #
#  ##       # #
###############