###############
#       4 #   #
### # # # #####
#     # #   # #
# # # #3### ###
#   # #       #
# # ### # # ###
# #E T#       #
### #2### #####
# # #       # #
# ####### # ###
# # S       # #
# ### # # # ###
# # # # #   # #
### # ### #####
# 5 # #1 7#   #
### # # # # ###
# # 06  #     #
# # # # ### ###
#   # #   #   #
### ### ### ###
# # # # # # # #
###############