###############
#T    S E     #
# # ### # # ###
# # # # # # # #
###############