###############
##   #      ###
##          ###
####     E  ###
####### S    ##
#######   T  ##
######   #   ##
###############