###############
# 1E#     # T #
# # # # # # ###
# #     # #0# #
# # # # # # ###
# S           #
# #####2### ###
# # # # # # # #
###############