###############
#    #####    #
# 1  ####     #
##   #### 0T  #
# 3 ######  S #
##  #### ### ##
###   #    2###
###      ##E# #
##        #   #
###############