################
#  E 2    4T0 ##
# ### # #1### ##
#6S #   # 7   ##
# ##### ### ####
# # # #     # ##
# # ### ##### ##
#   # #       ##
# # ### # ###5##
# #   # 3     ##
################
################