################
#   #         ##
# # #3##### ####
#   10    #  2##
###T# ### # # ##
#     # #     ##
# # # # #S### ##
#   #       # ##
###4### # # # ##
#   # #     # ##
# # ##### ######
#  E# # # #   ##
################
################