################
# # #     #   ##
# # # # # # ####
#     #     # ##
# ### # ### # ##
#   #     #   ##
### ### # ### ##
#   #     #   ##
##### # ### # ##
# #         # ##
# # ### ##### ##
#     #T  # # ##
### # # # # # ##
# #    S#     ##
### # ####### ##
# #   # #   #E##
################
################