################
# #         # ##
# ### ### # ####
#1#       5 # ##
##### ###2#4####
#7            ##
##### # ### # ##
#   # # S #  0##
# #3# # ### # ##
#   #       # ##
### # # # # # ##
#   #       E ##
# # ##### ### ##
# #8#         ##
# # # # # ######
# # # # #     ##
##### # ### ####
#  6     T  # ##
# # # ####### ##
# # # # # # # ##
################