################
#             ##
# # # ##### ####
#           # ##
# ### ##### ####
# #   #   #3#1##
#2# # ##### # ##
#E# # # # #   ##
# # # # ##### ##
# #     # #   ##
### ### # # ####
#T    4  S    ##
##### #0# # # ##
#   # # #   # ##
# ### ### ### ##
# # # # # # # ##
################