################
#     #   # # ##
# # ### # ### ##
#   # T #     ##
# # # # # # # ##
#           # ##
### # ### ### ##
#   # #   #   ##
# # ### # ### ##
#   # # #     ##
####### # ### ##
#  S    # E # ##
# ### ### ### ##
# # # # # # # ##
################