################
# E #   #   # ##
# ##### # # ####
#     #     # ##
# ##### # ### ##
# T #     # # ##
### ### ### ####
#     #   # # ##
# # # ##### # ##
# #   #       ##
##### # # # #S##
#     # #   # ##
# ### # ### # ##
#           # ##
# ### # # # # ##
# #       #   ##
# # ### ##### ##
#           # ##
##### ### # ####
#   #       # ##
# # # # ### ####
#     #   # # ##
# # ### # # # ##
# #     #   # ##
################
################