################
#   # # # # 0 ##
#T### # ########
#     2   #   ##
######### ######
# #   # #   # ##
# ####### ### ##
# #     # S   ##
# # ##### ######
#   #   # #   ##
# ### ##### # ##
#       #     ##
#####5### # ####
# #  4#   # # ##
### # ### # ####
#         #   ##
# # ### # # ####
# #   #3     E##
### ####### ####
#        1#   ##
# # # # # # # ##
#   # 6 # # # ##
################
################