################
###       2    #
## E  ##      ##
###  ## #      #
##  S   # #    #
#        # #   #
#       #  ### #
#      ##7######
#  3      ######
###      ##### #
####     ### 0 #
######  ##     #
####### #   T1 #
##  ###        #
##  # #      # #
## #  4###  ## #
### 6##  ####  #
###5 #    #### #
#### ##   # # ##
#  #  # ##   # #
#       ##     #
#    # #  ##  ##
##  ###  ### ###
###     ###  # #
#####   ##     #
###########    #
################