################
# #         # ##
##### ### # ####
#           4 ##
### # ### # # ##
# 1 2 #E  T # ##
### # # # ### ##
#             ##
# # # # # ###0##
#         #   ##
# # ### ### # ##
# # #       S ##
# ### ### # ####
#     #     # ##
# # # ####### ##
# #3# #   #   ##
####### # ######
# #       #   ##
### ### ########
#         # # ##
# # # ### # ####
# # # # # # # ##
################