################
#         # # ##
# #0# ### ######
#       # # # ##
# ### # # # # ##
#   # # #1    ##
# # # # ### # ##
# #           ##
# # # # # # ####
#   #     # # ##
# ### # # ######
#         #   ##
# # # # ########
# # # # #     ##
### ##### # ####
# # #     #  2##
#E# # ### # # ##
#     #  T# # ##
#S### # # # ####
# # #     #   ##
# ### ##########
#     # #     ##
# # # ### # ####
# # # # # # # ##
################