################
# 0       #2  ##
#E### ###1######
# # # #  T    ##
### # # # # #S##
# # # # # # # ##
################