################
##      ##    ##
#  2T3  ##E S4##
#       ##    ##
#   0# # 1     #
#  ####  #     #
######   ####  #
################