################
#   # T   #   ##
### ### ### # ##
#             ##
### # # #S### ##
#   #  E    # ##
# # ##### ### ##
# # # # # # # ##
################