################
#             ##
# ### #E# # # ##
# # # #   #   ##
# # ##### ### ##
#       #     ##
# # # ### # #T##
# #   # # #S# ##
################
################