################
#   #   #4    ##
###0# ###1# ####
# #           ##
### #3# ##### ##
#   #      T S##
### ##### ###2##
#             ##
### # #E# # ####
# # # # # # # ##
################