#################
# # #     0     #
# # ### #S###T###
#   # 2   # #   #
# # ### ### #####
# # #     E   # #
##### # # # # ###
#   #3#         #
# ### # ### # ###
#     4     # 1 #
#################
#################