#################
# #           S #
### # ### # #####
#       # T   # #
# ########### ###
# #             #
# # ####### # ###
#     5   #     #
# ######### # ###
# #  7  1     # #
###2# # # #8#####
#         #     #
### # # # ### ###
# #     6 # #   #
### ####### # ###
#0  #  3    #   #
# ####### ### ###
# # #4    #     #
### # # ### #E###
# # # # # # # # #
#################