#################
#       # #  2  #
# # # # #S#######
#       #    T# #
# ########### ###
# # #   #     # #
# #E### # ### ###
#   #6  #  1    #
### #5# # #######
#3        #7#   #
### ### #0# # ###
# # # # #   #   #
####### # ### ###
# # # #   #  4# #
#################
#################