#################
###   ##       ##
###### 3       ##
#######    #   ##
#####   0 # #####
#####      ######
####        #####
###          ####
##4 E 2     #####
###         ##  #
###         1   #
####       ##   #
####    S # #   #
###        #    #
##             ##
##T          #  #
#          #### #
#       ## ###  #
#  #    #   ##  #
# # #     6 ##  #
## ###     #  5 #
###        #    #
###     # #    ##
##    #####     #
#################