#################
#   S     # # # #
# # # # ### #####
#       #     # #
# ###T### ### ###
# #   #       # #
# # # # # # #####
#    E          #
##### ##### # ###
# #         # # #
######### ### ###
#         # #   #
### # # # # # ###
# # #   # #     #
### # # ##### ###
#       #   # # #
# # # # # # #####
#   #     #     #
####### # ### ###
# #     #   #   #
##### # # # # ###
# # # # # # # # #
#################