#################
############    #
############    #
##########  ##  #
#########    # ##
##########    E##
###   # ##    ###
##          #  ##
##         ##  ##
##       ########
###       #######
####         S###
#####      #  ###
####     ## ## ##
####      ##  # #
###      ### # ##
##    #   ### # #
### #####  ###T #
###  ###   ##   #
## #    #       #
#  ##  #        #
#################