#################
#      ####E #  #
#   0###### 2 ###
##     ###      #
#  # #T 1#S  ####
#################