#################
#       #     # #
# ### # ##### ###
# # T #    SE   #
# ##### # # # ###
# # # # # # # # #
#################