#################
###    ##  ##   #
#       #  T#   #
#           #  ##
#         ####  #
#          #    #
#   # S E       #
#  ####       ###
#################