#################
# #   1   T     #
#4### ###2# # ###
#     #         #
### ### #########
#     #S      # #
### # # ##### ###
#   #0      #   #
###3#E# ##### ###
# # # # # # # # #
#################