##################
#     # #       ##
# # # ### ##### ##
# # #    0  # # ##
# # # # ### ### ##
#         # # # ##
####### ### # # ##
#   # #   S     ##
# # ####### # # ##
#         #     ##
# # ### ### # ####
# # #         # ##
# # # # ### # ####
# # #   E       ##
# # ### ### # ####
# #   #     # # ##
# ### # # # # # ##
#T#   #     # # ##
##################
##################