##################
#         # # # ##
##### ##### # # ##
#    E    # #   ##
# ####### # # # ##
#  T            ##
# # # # ### ### ##
# # # # #   # # ##
### # # # # ### ##
#   # # #   #   ##
# # ### # # # # ##
#   #  S# #   # ##
# ##### ### # ####
#     # #     # ##
# # # # # ########
# # # # # # # # ##
##################