##################
### #  0    ######
##   ##    # # # #
###  # #  #      #
##    # ####     #
#  ### E#### 2  ##
#  ##    ##1   ###
#  S       #     #
#T ##   ###      #
#   #  #  #      #
##    ###       ##
##################