##################
##  5 ######  #  #
##    ######   # #
##### 3#####  # ##
#### # ####    ###
####  ###### #####
###  ###### ######
### ## ###  ######
## #    # # ######
##  #   #  #######
# ###  #   4######
#     ####   #####
# #  ####   ######
###   ###   #  ###
###   ### 1   6###
##  T    #   2####
## # E7##     ####
# #### ##      ###
#     # #  S 0 ###
#       ##########
#      ###########
##################