##################
#   #         # ##
### # ##### ######
# # #   #   # # ##
# # ### # ### ####
# #     # 1   3 ##
# ##### #5# ### ##
#6# #         0 ##
# # # # ### # ####
# #       #   # ##
####### # # # # ##
#      T# # # # ##
# # ### # # # # ##
# # # # # #   # ##
# ###E# # ### ####
#       #2  #   ##
# # # # ### ######
#   #   # # # # ##
# # # # # # ######
#       #   S   ##
#4### ### ########
# #     # # # # ##
##################
##################