##################
# #   #   #     ##
# # # ###4# ######
# #6#   #      5##
#0### # # # # # ##
# #      T     S##
# #2### ### ### ##
#   # # 3 # # 7E##
### #1##### # # ##
# # # # # # # # ##
##################