###################
##   ####  ## ## ##
###  ######  5  6 #
# 3 ## ####  # #  #
#       #### ###  #
#     E S#  #######
#          ########
#        2 T### ###
#       7  #  1   #
#          # ###  #
#      ####  #  # #
#  0   ### ##   ###
#    8  ##   # ####
###  ## ##  ##  ###
#### ## #### # # ##
####     #   4# # #
###     #     ##  #
###################