###################
# #     #   #     #
# ### # ##### # ###
#   #       #   # #
#T##### # # ### ###
#      S    #     #
# # ### ### # # ###
# # #   # #   #   #
# ### ### ### # ###
# #       # # # # #
### # # # # # # ###
# # #         # # #
# ### ##### # #####
# # # # # #E    # #
###################
###################