###################
##   #### S  # #  #
# #  ###          #
# ###  #  0   ##  #
#####   #    T ####
####  2 ##       ##
###      #        #
###             # #
###  #   ### # ## #
############## E ##
###############  ##
###################
#  ################
#  ################
# #################
###  #   #####  ###
## #1   #   #     #
#  ##  #    #     #
###################