###################
# #     #       # #
# # # # ### # #####
#     0 E #   #   #
# # # # # # # #####
#              4  #
# #1# # # #T#######
# # #   #   # # # #
### ##### ##### ###
#    3        #   #
# # ##### ### # ###
# #         # # # #
# ### # # # # #####
# #     #         #
### ######### #####
# #     #   2     #
##### # ####### ###
# # # #S#   # #   #
###################
###################