###################
###    ###        #
# #     ##      E #
#0##5   # #   # 4 #
######    ##3##   #
######      ## #  #
########      #   #
##   ###     1    #
##    #### #T   2 #
#      ##### S    #
#     ####  #     #
###################