###################
# #       #       #
##### ### # # # ###
# S             # #
# # # # # ##### ###
# #    E  #       #
# ######### # # ###
# # # # #  T  #   #
# # # ### # ### ###
#   # #       #   #
# # ######### #####
# # # # # # # # # #
###################