###################
#     # # #     # #
### # ### # # # ###
#   #       # #   #
### ##### # #4#####
#   #     #     # #
# # # # ##### #####
#       #     #   #
# ####### #########
# #      T        #
# # # # # ### #####
# #E#       #   # #
# # # # ### #######
#            1# # #
#####0# # # ### ###
# # # S # # # #   #
### # # ### # #####
#         #   32  #
### ### # # ### ###
# # # # # # # # # #
###################