###################
# # #   #   # #   #
### # # # # ### ###
# #       #   E   #
# ##### # # # #####
#   #   #   #     #
##### ### # # # ###
#   #       #   # #
# ### ######### ###
# # # # # #    3  #
### ######### #####
# # #   # #     # #
##### # # ### # ###
#       # #   #2# #
###T# # # # # # ###
# #             # #
# # # ### # #######
#   # # #   # # # #
##### ##### #######
# 01#         # # #
##### #4# # # #####
# #   #      S#   #
### # # # # #######
# # # # # # # # # #
###################