###################
###     ##  ##    #
##      #   #     #
##      3#      # #
###    2 #  E   ###
# 1 #   0 #  ##  ##
#   ##     ###   ##
#    T     ##  5  #
#####     ##      #
#####             #
#### # S         ##
#  #  #4     # ####
#   ####   ###### #
#  ############## #
#  ############## #
#########   #######
# #######   #######
# #########  ##   #
#  ########       #
# ######   #      #
# ######  #    #  #
#########  #  #####
###################