###################
#0 1 S T          #
#E# # # # # # #####
# # # # # # # # # #
###################