####################
#   #   # # #     ##
# # # ####### ### ##
#   #     #     # ##
### # ####### # ####
# #   # #E        ##
# # # # ### ### #T##
# #S# #   # #     ##
### # ##### ########
#   #   #         ##
# ### # # ### # # ##
#   # #     #   # ##
##### # # ### # ####
#   #     #       ##
# # ### ####### # ##
#   # # # # #   # ##
####################
####################