####################
#########  ###     #
####  ##   #########
###    E    ########
## 4   0   #########
##        6#########
##          ########
#    S       #######
# 2           ######
#     1    ## 5#####
#           ##T#####
#      #    ##  ####
#  # 3######## #  ##
# #############    #
####################