####################
# E     S     # # ##
# ##### # ####### ##
#   #   #         ##
# # # # # # # ### ##
# #       #     # ##
### ### ##### # ####
# #       #       ##
# # # ###1### # ####
#     #           ##
##### # ####### ####
#   # # # #       ##
#0### ### # # #T####
# #     #     # # ##
# # # ##### # # # ##
# # #     #   #   ##
# # ##### # # # ####
#       #   #     ##
##### # # ### ### ##
# # # # # # # # # ##
####################