####################
#   3     # # # # ##
# # ### #S### # ####
#           #   1 ##
# ##### ####### ####
# 0 # # # # #     ##
# # # # # # # ### ##
# #       #   #   ##
### ##### # ### # ##
#    T# #   #   E ##
######### ##########
# #     # #     # ##
# # # ### # # # # ##
#     #   # #   # ##
# # ##### # ### # ##
# #   #     # #   ##
###2# # ##### # ####
# #   # # # # # # ##
####################
####################