####################
# # #     # # #   ##
# ### # # ### ######
# #    E  # # #   ##
# # # # ###3########
# #   4       S5  ##
####### # # # # # ##
# #         # # # ##
### # # ### # # # ##
#   #            1##
### ### # # # #2#0##
#   #6# # # # T # ##
####################
####################