####################
#   #           # ##
# ### ### ### # ####
# 1T# # # # #     ##
######### ### # # ##
#     # #     # # ##
### # ### # # # # ##
#   #   #   # # # ##
# ### ### ### ### ##
#     #   #     # ##
### # #0# # # # # ##
# #         #     ##
###3# # # # # # # ##
#E    #       2   ##
### # ### ###S######
# # # # # # # # # ##
####################