####################
#  0#   #   # # # ##
# # # # ### ### # ##
#               E ##
### # ### ### # # ##
#   # #       # # ##
# # # # ### ### ####
#     #  2  #   T ##
# # # # # # # # # ##
# #     # #   #   ##
### #1##### ### # ##
# #     S # # #   ##
# # ####### ### ####
# # # # #3# # # # ##
####################
####################