####################
#  ##  2 ###########
#   ## #####  #  # #
#   ########       #
##   ####     6    #
##  ####           #
###### S       ##  #
######  #     ##   #
# ###  ##         ##
# ####       E     #
#  ###     34 ##   #
# ####       ####  #
# ####     ##    # #
##   #T 5 #     ####
#        ##    #  ##
#      ##       #0 #
#      #      1### #
#              ### #
# ###         ######
##   ##         ####
#    ###        ####
####################