####################
# # #     # #     ##
# #E# ######### # ##
# #     #   #5  # ##
##### ### # # # ####
# #     # #    T  ##
# # # ### # # # ####
# # #     #    S# ##
# ####### # ##### ##
#                 ##
##### # # ### # ####
# #   # # # #  2 0##
### # # ### ##### ##
# # # # #   6   # ##
# # # # # ####### ##
# # #   #1#       ##
### ####### ### # ##
# 7   #     # 3   ##
# # # # # # ### # ##
#   4 #     # #   ##
# ### ### ##### # ##
# # # # # # # # # ##
####################