####################
#T       2 S   E0 ##
# # ##### # # #1# ##
# # # # # # # # # ##
####################