####################
#         ##       #
#   0###  ##1   ####
##        #      E##
#  # # T  #S  ######
####################