####################
# 0 #      3     6##
### #E### # ### #1##
#5      #   # #   ##
# # # ### #2##### ##
#    S# #T#   4 # ##
####################
####################