####################
#2   0  #    S# # ##
### # # ### # # ####
# #           #   ##
##### # # #####T# ##
#      3          ##
# # # ### # ### ####
#1  #   # # #  E  ##
####################
####################