####################
# E   # # # # T0  ##
# ### ### # # ### ##
#         #   # # ##
# # ### # ### ### ##
# S # # 1 3 #     ##
### # ### # # # # ##
#     #   # # #   ##
##### # # # # #2# ##
# # # # # # # # # ##
####################