#####################
#       E # 6 # # # #
# ### # # ### #######
# # #   #    T4 #   #
### # ###############
#  5  2     # # 0 # #
### ### ### # ### ###
# # # # #         # #
### # # ### # # # ###
#    3      # #  1# #
##### ### # # # # ###
#   # # #   # #S# # #
#####################
#####################