#####################
# ######  #####   6##
#####  2  # ####  ###
# T          ########
#   # E #### ########
# S ##   # #4 #######
#    ####   # #######
##   ####  #    3 ###
##    #####       ###
#### 0##  ###    # ##
#### ###   #  7 # 5 #
### ##1 ##   ###    #
## #   ########     #
#  ##  ########   # #
#      ####  ##   ###
#####################