#####################
#   # #         #0  #
### ##### #E### # ###
# #   # 2     #     #
### ######### ### ###
# #   # # # #   # # #
# #1# # # # # #######
#       4 # #   #   #
###T### ### # # # ###
#         #    S    #
# # # ### ### ### ###
# # #         #   # #
### # # ### # # #####
# #   # #         # #
# #3# # ### ### # ###
# # # # # # # # # # #
#####################