#####################
#   #     # # #     #
### # ##### # #######
#1  # # # #         #
# ##### ### # # # ###
#     #   #  8S # 7 #
### # ### # ### #####
# #             5 # #
### # #0### # # #####
# # # # E     #   6 #
### # # ##### #######
#              4    #
####### #T# ### # ###
# #       #3# #     #
# # # ### # ### #####
#       #  2  # #   #
# # ####### # #######
#     # # # # # # # #
#####################
#####################