#####################
#8#   #    3  # #   #
# # ##### ### # #####
#   # 0  E    # # # #
# # ##### # #########
#             #     #
# ### # ### # # # ###
# #     T  S  #   # #
### # # ##### # # ###
# #5# #7# #2  #     #
# # # #6##### ### ###
#   1           # 4 #
# ### ####### # # ###
#   #       # #     #
# # ##### ### # #####
# # #   #   #     # #
# # # # ### # ### ###
# # # # # # # # # # #
#####################