#####################
#     # #  E   1    #
###4### # # #########
# #S    #   #   #   #
# # # ### ##### # ###
# # # # T   #       #
### ##### #3##### ###
#         # #     # #
# ### # ####### #####
#       # #   #   # #
# ### # ### # ### ###
#       # # # #   # #
# # ########### #####
#   # # # #         #
### ##### ### #######
#   # #   # #   #   #
# ### # # # ### # ###
#  0  #           # #
# ##### ### # #######
# #  5  2 #     # # #
#####################
#####################