#####################
#             # #   #
# ##### # ### # #####
#     #     # # #   #
# ### # ##### # # ###
#   #   #   # #     #
# # # # # #S##### ###
# #                 #
### ####### ### #####
# #     #   #       #
# # # # # # ### # ###
#     # # # #   # # #
# ##### ### ##### ###
#   # # #     # #   #
##### # # # # ### ###
# # E       # #     #
######### # # #######
#     # # # #     # #
### # # ### # # # ###
#T            #   # #
# # # # # # # ### ###
#   #     #   #   # #
### ### # ###########
# # # # # # # # # # #
#####################