#####################
#         ##        #
#    ###  ## 0   ####
##        # #     E##
#  # #    #S T ######
#####################