#####################
#    S0  E      # # #
#2#1### #T# ### #####
#   #     #3    #   #
### # # ### ### # ###
# # # # # # # # # # #
#####################