#####################
# # #     # #  2  # #
# # #E# ### ###3# ###
# S #   # #     04  #
#5# # # # # # ### ###
#  1  # T         # #
##### # # ### # # ###
# # # # # # # # # # #
#####################