#####################
#   #   1 # # # S # #
#2# ### #0# # # # ###
#4#T7  E  #         #
# # ### # # # #######
# #       #  65   # #
#3### #8# # # # # ###
#   # #     # # # # #
#####################
#####################