######################
#   #   #   #       ##
# # ### # # ##### # ##
#   # #         #   ##
# ### ### # # # ### ##
# #   #   # #     # ##
##### # # ### ########
#   #         #  0# ##
###1# ##### # # ### ##
#     #5# # #     # ##
# ### # # ##### # #S##
#2    T   #       # ##
### # # ### # ### # ##
#   # # # E3        ##
### # ### ### # # # ##
#   #       #       ##
# ########### ### # ##
# # # # # # # 4 # # ##
######################
######################