######################
#   # 4         #   ##
### # # # ###0### # ##
#   #   # #     #  S##
### ### # # # ##### ##
#       # #   #     ##
# ##### # # ### ### ##
#   #    5#   # #   ##
##### ### # # # ### ##
# 2       #T 1   3  ##
### # # # # # ### #E##
# # # # # # # # # # ##
######################