######################
#     # #2      #  4##
### ### #1######### ##
#   #            S# ##
# #E#  ## # # # # # ##
# #     #  0#   #   ##
# # #  ## # #######3##
#   #   # #         ##
### # # # # #5# ### ##
# #  T  #     #     ##
#                    #
######################