######################
#   # # # # #   #   ##
### ### ### # # ### ##
# #T#     1   #     ##
# # ######### ### # ##
# #   #           # ##
##### # ### ##### # ##
#   #   #      0E   ##
# # # # # ##### ######
#  S  #           # ##
##### # # ### # ### ##
# #       #   #     ##
##### ### ### # # # ##
# # # # # # # # # # ##
######################