######################
#       #     #   # ##
### # # # ### #3# ####
# #   # #           ##
### ### ### ##########
#   #     #  S#     ##
# ### ### ####### # ##
#   #   12       0# ##
# #T### # # # # # # ##
#   #       #       ##
# ### ### ### # # # ##
# # #   #     # #   ##
# ##### # # ##### # ##
#     #   # #   # # ##
# # ##### ### # ######
#     #     #       ##
# # #E# # # # ### # ##
# # # # # # # # # # ##
######################