######################
# T     #     #     ##
# # ### # #E### # # ##
#1      #   0S    # ##
### # # # # # # # # ##
# #   # #     # #   ##
######################
######################