######################
# #           # # # ##
# # # # # # ### ### ##
#  T    #   #   1 # ##
# # # ### # # ##### ##
#     2 #       #   ##
### #S# # ##### #E#0##
# # #   # #  3    # ##
######################
######################