######################
# T     # #   #0  # ##
# # ### # # ### # # ##
#   #   #       # # ##
# # ### # # # # # # ##
#    E    #     # # ##
##### # # ####### # ##
#       #S#         ##
# ### ### ### # # # ##
# # # # # # # # # # ##
######################