#######################
#       #             #
##### ##### # ### #####
#T# E   #     # #     #
# # ##### # ### #######
#         #     # #   #
######### # # # # # ###
#     # # #           #
# ### ##### ### ### ###
# #   #   #       # # #
# # ###S# # ####### ###
#   # # #   0 # # # # #
#######################
#######################