#######################
#    0  # #   #     # #
# ### ##### ##### # ###
# #     1    2# #     #
####### # # # ##### ###
# #     # # # #   # # #
# # # # ### # # # # ###
#  E# # # #         # #
##### # # ### # # # ###
#         #    4#     #
# # # # # ##### ### ###
# # # # # #     T3# # #
### ##### # # #S# # ###
# # # # # # # # # # # #
#######################