#######################
#           #   # # # #
# # # ### # # # ### ###
#S 0# #   #       #   #
# ##### # # # ###1# ###
# #       #   #   #   #
# # # #2# # ### #######
# #           T #     #
# # # ### ### ##### ###
#E# # # # # #      3  #
#######################
#######################