#######################
#       #     ES#     #
# # ##### # ### ### ###
#         # # #   #   #
# ### # # # ### #######
# # #   #     # # #   #
# # # ### ##### # # ###
#   # #       #       #
##### # # # # # #######
#           #T      # #
### # # # ####### # ###
#   #       #   # # # #
### # ### ##### # #####
#   # # #             #
##### # ###############
# # # # # # # # # # # #
#######################