#######################
# # #   #   #   #     #
##### ##### # ### #####
# #     #       # 3   #
# # # ### ##### # #####
# #       #5      #   #
# ### # ### ##### # ###
#   #       # # E     #
# ### # # # # # # #####
# # #   #S  #   #   # #
# # # # ####### # # ###
# #   # #     # # # # #
########### ### #6# ###
#  0 2#       #   T 1 #
##### # ### # #########
#   # # #      4#     #
# # # # # # # ### # ###
# # # # # # # # # # # #
#######################