#######################
# # # #   #   #   # # #
# ### # # ### # # #####
# #             #     #
# # ####### ###3# # ###
# #         2   #  4  #
# # #######S# ### # ###
#   #   # # # #     # #
# ### # # ### # # #####
# # #       # #     # #
###T# # ### #0##### ###
# #     #     #   #   #
##### ### # ### #######
# #     #     #   E   #
# ####### # ### ### ###
# #       #   #   #   #
# ### # # ### # ### ###
#   #1  #   #     #   #
#######################
#######################