#######################
# #3# # # 6 #   # #   #
# # #7#4### ##### # ###
#             1 #   T #
###2# ### ##### # # ###
#                     #
###E# # ####### ### ###
# #   #   58#     S   #
####### ### ##### # ###
#     #  0  #     #   #
# ##### ### ###########
# # # # # # # # # # # #
#######################