#######################
#T# #0#           S   #
# # # # ####### # # ###
#   1     E #         #
#######################
#######################