#######################
#         ##          #
# 2  ### 1### 0   # ###
##        #         T##
#  # #    #S #E ### ###
#######################