#######################
# E  4    1 # #0      #
# # # ### # # # # # ###
# #32   #    T#       #
###S# # # # # # ### ###
# # # # # # # # # # # #
#######################