#######################
# # 2 # #E            #
# # # ##### # #1# # ###
#      S   T#         #
### # # ### ##### # ###
# #         #         #
# # # # ### ###3# #0###
#   # # #     #   #   #
#######################
#######################