#######################
#   #         #  E#   #
# # ##### ### #T# # ###
#     S   #       #   #
# ### ### # # # # #####
#       # #   #     # #
# # # # #0##### # # ###
#           # # 1     #
### ### # # # ### # ###
# # # # # # # # # # # #
#######################