########################
# #T              #   ##
############# # # # # ##
#       #S  #      4  ##
### # # # ##### # ### ##
#   # # E # #     #  1##
#####6# ### ##### # # ##
#5# #           #32   ##
# ### ### ##### ########
#     #   #0          ##
### ### ### # # # ### ##
# #           # # # # ##
### # # # ####### ### ##
# # # # # # # # # # # ##
########################