########################
#     83          #   ##
# ###7# ##### ##########
# #   #         #   #4##
### # # ### ### # ######
#            ET #   #1##
# ###5############### ##
#   # # #     # # #   ##
#2# # # # ###6# ### # ##
# #S        # 0       ##
# ### ### # ### ########
# # # # # # # # # # # ##
########################