########################
#     #   # #   #   # ##
### # ### # # ##########
# #   #   #         # ##
### ##### # ##### # # ##
#                     ##
# # # ##### ##### ### ##
# #     #    1  # #   ##
##### ### # ### # #T# ##
#     #   #   #S  #   ##
# # ### #4### ### # # ##
# 5   #         #2# # ##
##### # # ##### ### ####
#       # 3 #     0   ##
### ##### ##### # # # ##
# E #     # #         ##
# # ####### ### # ######
#   # #       #   # # ##
########################
########################