########################
# # #   #     # #     ##
##### ### ### ### # ####
#              2    3 ##
# # # # # # ### # # # ##
# #   # #         # # ##
# # ### ####### ### #5##
#  6  #   # #   #     ##
### # ### ### ### #0# ##
# #       # # #     # ##
### # ##### # # # ######
#   #  1# #   # #  T  ##
# ################# # ##
#         #4#       # ##
# # ### #S# #E##### # ##
# #      7  # # 8     ##
# ### # # # # # # ######
# # # # # # # # # # # ##
########################