########################
# #         #         ##
### # # # ### # #S#2# ##
#     #     #       # ##
# # ##### ### #0### ####
#   #   #       # 1   ##
#T# ### # # ##### # # ##
#     #       #       ##
# ### ### ### ### ######
# # #   #E# # # # 3 # ##
########################
########################