########################
##### T  #####       ###
#####      #          ##
#####                 ##
#####                ###
##              E    ###
#              ##      #
#              ##      #
##    ##         ##    #
###   ##     ##  ##    #
####         ###       #
#####         ##      ##
######              ####
#######           ######
#  #####      S  #######
#   #####        #######
#    ########     ######
#       #####     ######
#        ####     ######
#          ##    #######
#               ########
########################