########################
#2T   7 # #   # #     ##
# ### ### ###S###1#0# ##
#  5  #    E 3  6 4   ##
### # ### # ### # # ####
# # # # # # # # # # # ##
########################