########################
# # #   #  S#       # ##
# # ### # # ### # # # ##
#       #   #E  # #0  ##
# ### # # # ######### ##
# #     # #           ##
# ### ### #T# ### # # ##
# #       #   # #     ##
#1# # # # # # # # # ####
# # # # # # # # # # # ##
########################