#########################
#     #       #   #     #
### ### ### # # # # #####
# # #           0 # #   #
# ##### ### ### # # #####
#   # #  2  # # #   #   #
### ##### ### ### # #####
# # #   #  E    # #     #
### # # # # ##### # #####
#  1# #   #     #   #   #
# ### # # # ##### # #####
# #               #   # #
# # # # # # # ### # # ###
# #3          T  4      #
# ####### # # #####S# ###
#       #     # #     # #
# # # # ####### # # # ###
# # # # # # # # # # # # #
#########################