#########################
# #         # #     S   #
### ##### #2### # #######
#     #   #   #   #     #
##### # # # # # ### #####
# # # #         #     # #
# # # # # # #############
# # 43#   # #   E #   # #
# # ##### # # ### # # ###
#   #   T #1 0  #       #
### # # ####### ### # ###
#   #     #     # # # # #
#########################
#########################