#########################
#     # # #   3 #   T   #
# # #S# ### # # ### # ###
# #  0# # # # E #1  2   #
#########################
#########################