#########################
#    1#0#23  4#   #   # #
##### # # ### # # ### ###
# # #   #     #7   5    #
# # # # # # # ### #S# ###
# # #     T #      6    #
### #E### # # ### #######
# # # # # # # # # # # # #
#########################