#########################
# #               #     #
# # # ### # ### # ### ###
#   # #   #  S  #       #
# # # # ### # # ##### ###
#         # #   # #     #
# ##### # ##### # # #####
#     #     # E   #T  # #
#########################
#########################