##########################
#     # T   # #         ##
# # ##### # ### ### ######
# #         # # #     # ##
####### # # ##### ### ####
#    E   S# #     #     ##
# ####### # # ##### ### ##
#   #     #   #         ##
### # # ### ####### # # ##
#                 #     ##
######### # ### # ### # ##
# #   # # #     # #     ##
########### ### ### # # ##
#   # # # #     # #   # ##
##########################
##########################