##########################
# # S         #E#       ##
# ### ####### # ### # # ##
#                 #     ##
# # ##### # # # ### # ####
#     #   #   #   # #   ##
# # ### ### # # # # # # ##
# #               # # # ##
### # # # # ### # # # ####
# #     # #     #   #   ##
# # # # ### ##### ##### ##
#   #     #     # #     ##
# ##### ### # ### ### # ##
#   #   # # # # #    T  ##
######### # ### ##########
#   #     #   # # # #   ##
##########################
##########################