##########################
# #        7  5      4  ##
### ####### # # ##########
# #     #   # #     #   ##
### ##### # # # # ##### ##
#   # # # #           # ##
### # ### # ### # ### ####
# #     # # # # # 0   # ##
# ### # ### ### # # # ####
#   # #           S #   ##
# # # # #######E# # ### ##
#     #   # # #   # #   ##
#2#6# ##### # # ##### #3##
#   # #1# #       T     ##
# ### # # ### ### # # ####
# # # # # # # # # # # # ##
##########################