##########################
#   #       # #     # # ##
# # ####### ### ##### # ##
#   #   # #     # # #   ##
####### # ######### ######
#     #   #   #         ##
# # ##### # # # ### # # ##
# #   #       #  S#   # ##
# # # # # ### # ##### # ##
# #   #   #   # # #   # ##
# # ### # # # # # ### # ##
# #         #   # #   # ##
# # # # # # # # # # # # ##
# #   #   #   #   # # # ##
### # # ### # # # # ### ##
#   # # #     # # #   # ##
# # # # # ### # ### # ####
# #     #   # #     #  E##
# # # #T### # ### # # # ##
# # #     # # #   #   # ##
##########################
##########################