##########################
#0    2 #       T # S 3 ##
# # # # # #1# # # #E# # ##
# # # # # # # # # # # # ##
##########################