##########################
#   # # #               ##
# # ### # # ### # ### ####
#             S #  1# # ##
# ### # # # # # #T# # # ##
#  E#          0  # #   ##
# # # # ##### ####### ####
# # #     #   # #4#2#3# ##
##########################
##########################