##########################
##### 1 8      ###########
##  #       ## ###########
#3   ##    #S #  #  ######
## ## # ### E       ###  #
# #   ##    #       ##   #
#      0  ####      ##27 #
#   ##6  # ####        5 #
##  ### ## 4 ###   T     #
#########    ####        #
##########################