###########################
#   0   #     # # # T #   #
# ##### # ####### # # # ###
#                 #     # #
# # ### # # # ####### # ###
# #   #E#   # #     # # # #
# # ### # ### ##### # #####
# # 2 #                 # #
# # # ### ########### # ###
#   #   #  S      # # #   #
# # # # # ### # ####### ###
#   # # #   # #     #     #
# # ##### ### # # # ### ###
#           #   #     1   #
# # # # # ### # # ### #3###
# # # # # # # # # # # # # #
###########################