###########################
#               #0    #   #
# # ### ### ### # # # #####
# #       #   # # S # # # #
# # # ####### ### #########
# #         #   #   #     #
# ##### # # # # ### ### ###
#     # #   # #     # # # #
# ##### # # # ##### # # ###
# # #       #     2     E #
#1# ### ### # # # # #######
# #   T         #   # #   #
### # # ### # ### ### #####
# # # # # # # # # # # # # #
###########################