###########################
#         # # #       # # #
##### ###E# # ##### # # ###
#    S#   #           2   #
# # #0# # ### # # # #T# ###
# #           #   #     # #
### # ##### # # ### # # ###
#1# #       #    3    #   #
# ##### # # # ### # # #####
#   # # # # # # # #   # # #
###########################
###########################