###########################
# #   #3        # # #  5  #
### # #S# # ##### # ### ###
#     #   # #   0         #
#######4# ### ### # # #####
#         #       # #   # #
# # # # ##### ##### #E# ###
#   # #                 T #
# # # # ### # # # #########
# 2   #         #     #   #
####### ####### # ### #####
#   6 # # # #   # #   #1  #
###########################
###########################