###########################
#               #         #
# # # # # ##### # # # # ###
#T#   #   S E   #         #
###########################
###########################