###########################
#    E         T          #
# # ### ### # ##### # # ###
# S     # 3      2   0    #
#1# # # ### # ##### #######
# # # # # # # # # # # # # #
###########################