###########################
#   #   # S           #   #
### # # ### # ##### ### ###
#       #       #         #
# # #E### #1# # # ### # ###
#   # T   #   0       # # #
# # ##### # # #2# ##### ###
# # # # # # # # # # # # # #
###########################