############################
# #   #   # #  3    #   # ##
# # # ##### ############# ##
#           #         # # ##
# # ### #T# # ### #S### ####
# #         # #       #   ##
# # # ### # # # # # ###2# ##
#     #     # # # # #1#   ##
# ### # ##### # # # # ######
# #             # #0  # # ##
### ##### # ########### # ##
#     #             #     ##
###E# # # ### # # # # # # ##
# # # # # # # # # # # # # ##
############################