############################
# # #       # # #         ##
### ### ### # # ##### # # ##
#                   #     ##
### ##### ### ##############
# # #           #   # # # ##
# # ### ### # ### ##### # ##
#   #       # #     #E    ##
# # # ### ##### # ### # ####
# #     #   #         # # ##
# # ### ### ### ##### # # ##
#   # #   #     # # #0T   ##
# # # # # ### ### # # # ####
#   # #   # #  1 S    #   ##
#################        ###
############################