#############################
#         #     #   #     # #
#5# # # # ##### # ##### #####
# 0         # #     #   # # #
# ### ##### # ### # # # # ###
#     # # # # S    E  # #   #
# ### # # # # ##### ##### ###
#     #       #7    # #   # #
# ### ### # ##### # # ### ###
# # # # 2 # # #T     14     #
# ######### # # # # ### # ###
# #       #         # 3 #   #
##### # # # ##### # ### #####
#   #   #   #   #6# #     # #
#############################
#############################