#############################
#     #    T    # #       # #
# ### ### ### # ####### # ###
#2# #     #          1  #   #
# # ##### ### # ##### # #####
# #     #   #          S#   #
# # ##### # # ### #E# # # ###
#     #   # #             # #
# ##### ### #0### # ### #####
#   # #       #         # # #
# # ### # ####### ### # # ###
#   # #   # # #   # # #     #
#############################
#############################