#############################
# #   E #   #       #       #
### ### # # # # # # ### # ###
# #     #   # # # # #   #   #
##### # # ### ##### # # # ###
# # # #T      #       #     #
# # ### # # ##### # # # #####
#   #    S      # # #   #   #
# # ### # ##### # # # # #####
# # # #     # #   #   #     #
# ### ### # # ### # # ### ###
#   #   #   # # #   #   # # #
##### # # # # ######### # ###
#   # # #   # #       # # # #
########### # ### ### # # ###
#   #   #         # # # #   #
##### ##### # # ### # # #####
#   #       #     # # #     #
# ####### # ### # ### # # ###
#     # # #     # # # #     #
# # ### ##### ### ### #######
# # # # # # # # # # # # # # #
#############################