#############################
#      E            T     # #
#0# # # # # # ### # ###S#1###
# # # # # # # # # # # # # # #
#############################