#############################
#     T 5   # #   74 S12    #
### ### #E#0# # # ### #######
#     #         # # 3       #
# # # # ### ##### ### #6#####
# # # # # # # # # # # # # # #
#############################