#############################
#   6     # #   #  0    # # #
# ####### # # ### # ### # ###
#     # #         #   # #7  #
# #3# # ### # ### # # # # ###
# #   T #S#        4#   # # #
# #1# ### # # ##### # # # ###
#  25 E   # # # # #     # # #
#############################
#############################