##############################
#  # # ###            ########
##  #       3    #    ###  ###
##  S    2 # ## # #    #   ###
#         ###### ##   #  #####
# ###1   ###  #  #    ########
####### ###   T ## ###########
########### # 04# E #######  #
####  ###  ##  ##  ########  #
####  ###  ###################
####  ########################
##############################