##############################
#   # # 1     #         # 4 ##
# # # #0##### ##### # ### # ##
# #   # #           #       ##
### ### # # ##### # # ########
#   # #           # #       ##
### #E# # ### ### # ### ### ##
#   #   # 3 # #       5 # # ##
# ### ### ##### ### # ### # ##
# #   #  T# #         #     ##
### # ####### # #S# # # # ####
# # # #   # # # #2  #     # ##
##############################
##############################