##############################
#  2     0      E     # S1  ##
# # ### # # # ### # # #T### ##
# # # # # # # # # # # # # # ##
##############################