##############################
#     #    E            #  S##
### ### # # #T### # # # # ####
# #   # # #     # #         ##
##############################
##############################