##############################
#           # # #     # #   ##
# # # # #0#E# # #T##### # # ##
# #S      # #   #1#   # #   ##
# ### ### # # ##### # # # # ##
# #     # #     #     #   # ##
##############################
##############################