##############################
# 3    T#5      #         # ##
##### # # # ### # # # #####2##
#       #   #     S6   E#   ##
# ##### # ##### # # # # #1# ##
#   # # # # #     #         ##
# ### # # #0# #4# # # # # #7##
# # # # # # # # # # # # # # ##
##############################