##############################
################      ###    #
################53     0#    #
####   ######E #       # #   #
####  2 #  ##  ###   ####    #
#####  8   ### #####  ###T6  #
#### 7      #    ##   ##     #
#### 1      #4   ## S        #
###     #   #   ###    #### ##
##############################