##############################
#     #             #    1  ##
# # # ##### # #2# ###3### ####
#   # 7 #   # #   # #    S  ##
# # # # # # # # ### ###6### ##
#   # # 0   #     #      5# ##
# ### # #T# ### # ### ### # ##
#   # # #       #4          ##
# # # # #######8# # # #####E##
# # # # # # # # # # # # # # ##
##############################