###############################
#  #  #  # ##  ####### #####  #
# ### #  #  ### #####   ####  #
#0## ##  #  ##  ####     ##  ##
#     # #2  ##  ####  ##     ##
# ##  # #    ####### ##    ####
#  #   #    #######    1    ###
#   3   #         #         ###
#      ##         ###  #    ###
#####     #     #  # #####  ###
# #####  ##    # #     ########
# ###### 4     # #       ######
##  # ##      # #         #####
## T         #            #  ##
###  ##  E  ###          #   ##
##    ##   #  ###     S  #  ###
##    #     #  ####   ###   ###
##       ###   ###     #   ####
##   #######  #####   # #   ###
###############################