###############################
#   # # #   # T     # #       #
# # ##### # # # # # # ### # ###
#     #     #     #   #     # #
#1#####6# # # ### ##### # #####
# # #   # # #   #     #     # #
# # # # # # #2# # # # # # #####
#  5# 0 # #   #    3#E#     # #
# ### # # # # # #4# #S# # # ###
#   # # # #   # #     #   #   #
###############################
###############################