###############################
# #2  ########### T 7####1 E###
#5 3   ##0  #####4   ####S 6###
#      ##    ############  ####
###############################