###############################
#         4     # # 31# #     #
# # # # # # # # # ##### #0#S###
# T     #  E#            2    #
### # # # # # ##### # # # # ###
# # # # # # # # # # # # # # # #
###############################