###############################
#   #     #       # #   # #   #
##### # # # # # ### # # # # ###
#T#         S   #     # E     #
# # # ### ### ##### # # # #####
#       # # 0       #   #     #
# # ######### # # # ##### #2###
# # #     # # #   # #1#   #   #
###############################
###############################