###############################
#         #   #   #   #4      #
########### # # # # # # # #####
# #     # #         # # #   S #
# ####### # # # # ### # #T# ###
#   # #E  #2  #     #         #
# # ##### # ### ### ##### # ###
# #        3  # # 0           #
# # # # ##### # # # ###1# #####
# # # # # # # # # # # # # # # #
###############################