################################
#    ###  ## #######   #####   #
#    ###        ### ## ######  #
#  ###  E       ##   #  #####  #
#### #  #         #T##  ####   #
###     ## #   # #      ####   #
#   ##1#  # # # ###    # ###  ##
#   # ##   S0#  #       # ### ##
#      #2                 #### #
#     #3#   ###       ### ##   #
###    #     #    ##  #  ###  ##
################################