################################
# # # # # #                 # ##
### # ### ##### ### # # #####S##
# #   # #   #             # # ##
# ##### # #E### # # ### # # #1##
# # #   # #     #             ##
### ##### # ### # ##### # # # ##
#             2       # #   # ##
# # # # ##### # # # # # ### # ##
#   #     # #     #       # # ##
# # ### ##### ##### ####### ####
# # #       # # # T #       0 ##
# # # # # ### ### # ### ### # ##
# # # # # # # # # # # # # # # ##
################################