################################
#S                  E         ##
# # ### ### # # # # # # #T# # ##
# # # # # # # # # # # # # # # ##
################################