################################
#               #        T 1# ##
# # # # # ### # # ### ###3######
# # #   # # 20  #E6  4  #   S5##
################################
################################