################################
# #   #  0# #   # #   # #     ##
# # ##### ### ### ##### ### ####
#  S          # # #           ##
# #E# ### # # # ### ###2# # ####
# # # #  1#           # #     ##
# ### ####### # ### # # ### # ##
#     #   # #          T#     ##
# # # # # # # ### # ##### # ####
# # # # # # # # # # # # # # # ##
################################