#################################
#             #       #   #     #
### ##### # # ### # #T###########
#   0   #         #         #   #
### # # # # # ### # # ##### #7###
#   #     # # #      6# #       #
#3# # # ### #####S# # ####### ###
# # # #   #      1    #   # #   #
# # # ####### # # ##### ###E# ###
#       #   #   # # # #      4  #
### #2# # ######### # ###########
# # #   # # # # # #  5# # # # # #
#################################
#################################