#################################
######  #  #######   #  #  #  ###
#  #### #    ####     ## # ## ###
# # ## ##     ###   #####    ####
##  ##  #   ## #  ####  #    ####
# # #      ##  ##  ###     #   ##
## #         #            ##    #
#   # ##     #     # ##        ##
#   #  #    ##    # #  #   ##   #
####       #   T # ##  ## # #  ##
#         ##      ###    #  #  ##
#    ##   ###      ###     #  ###
#     ##  ###      ####   #   ###
##      #####     ####   ##   ###
#####   #####      ###  #########
##  ##  ## #  #      #   ########
#  #         ###   #  #  #####  #
# # ##       ###  ## ##  ####   #
#  ###        ##S # ##  ######  #
#   ###  ###  ###    #  ####### #
#  ####   #      ##    #######  #
# #######    E   #   ## ###     #
#########         #  ##  ##     #
##########     ###   ## #####   #
#  ###  ###   #####  #   ###    #
#    #  ##   #########          #
#################################