#################################
#  0    # #1#       #       #   #
# # # # # # # # ### ### ###4# ###
#   #            SE T # 2       #
#3# # # # ### ##### # # # # #####
# # # # # # # # # # # # # # # # #
#################################