#################################
#       # #S      #   #         #
# # #######0### #2# # #E##### ###
#         #         #      4# 5 #
# #1##### # ### ### # # #########
# 3 #   T # #           # #   # #
# ### # # # # # # ########### ###
# # # # # # # # # # # # # # # # #
#################################