#################################
#      6#T  #         #         #
# # # # # # ###########0# # # ###
# #               #     # #   # #
# #S##### ### # # # ##### # #####
# #     #   #       #     #     #
# ####### ### #4#####7##### #####
# # #    E    #           #1 25 #
# # # # # ##### # #3# ### # # ###
# # # # # # # # # # # # # # # # #
#################################