##################################
# # # # #       #   T     # #   ##
# ### # ### # ### ### ######### ##
# #         #     # # #   #     ##
# ### # # # ##### # # ### # ######
#   #       #   #   #       #   ##
######### ##### ### # # # ### # ##
# #           #       #   # # # ##
# # # # ### # # ### # # ##### # ##
# # #   #   #       #S# # #   # ##
##### # # ##### ### ##### # # ####
# #       #           # # #   # ##
######### # # # # ### # # ##### ##
#   #       #  E# # #       #   ##
### # ### # # # ##### # # ### # ##
# # # # # # # # # # # # # # # # ##
##################################