##################################
####        ##            #####  #
#  #        #  ###  #       #  0 #
#      ###      # ## #           #
#     ####  ##    # # #2   ## T  #
#       #####  ###     # #### #  #
# ##    ##### ###   ###  #    ## #
###       ### ###    #       #   #
#         ##   ###         ###   #
#        # #  ####        ####S  #
###    ###    ###          ## #E #
###     ### #  #              1# #
####        ###      #  # ###  ###
##################################