##################################
#S     0   2# # #   3  T      # ##
# # # ### # # # #E###1# # # # # ##
# # # # # # # # # # # # # # # # ##
##################################