##################################
#         #   4     #T  #   #   ##
# ### # ### ### # # # #E# # # ####
# 3  2# 5       #     # 1     S ##
# ##### # # # ### ###0# # # ### ##
# # # # # # # # # # # # # # # # ##
##################################