##################################
#   # # # # #     # #           ##
# # ### ### # # # # # # ### # ####
# # #0 S#T             1        ##
# # # ### ##### # # ### ### # # ##
#   #  E# #   # # # # # #       ##
##################################
##################################