##################################
# # #   #E  #   0   #    3# # # ##
### # # # #T# # # # # # ### # # ##
#S          #     #             ##
# # ### # # # ##### # # # # # ####
# #     # #   #     1         # ##
# # # #######2### # # # # ### ####
# # # # # # # # # # # # # # # # ##
##################################