##################################
#   #     #     #       #   #   ##
### # ####### # ####### # ### # ##
# S   # #        T      #       ##
#0# # # # # # #E# ### # # # # # ##
# #   #                 #     # ##
# ### ### ### ### # # # # # ### ##
# #   #     # # # # #1# # #     ##
##################################
##################################