###################################
# #   # #     #5#         #3  #   #
# # #S# # # # # # #2### # # # #####
# # # # # #  4      # # #   #     #
### #T### # # # ######### # # # ###
# # # #   #     #   #E#   #       #
### #1# # # # ####### # # ###6#####
# #   #     #0#   #       7     # #
### # # # # ### ####### # ### #####
#     #         # #   # # # # #   #
###################################
###################################