###################################
#      #     ####          #  #   #
##     #####  ###        ## ##  ###
#      #  #   ###   S    ## #   ###
#   #  #   ###         E  #  #  ###
## ## ### ###          T    #    ##
### #     ###             ####  ###
#    ###    #          ############
# ######## #            ###########
#  #### # # ####         ##########
#  ###      ######       #####  ###
#            ##### #####  ####   ##
#      #   # ##### ######   ###  ##
#    ###  ###   #  #####    ##   ##
#  ####    ###      ###    ###    #
########  ###       ###       #   #
########  ##      #####      #    #
####   #####      ######  #   #   #
###        ##      ##### ##  #    #
#       #       ## #####  # ###   #
#     ###       ##  ###     ###   #
#     ####     #    ####       # ##
#    ######  #### ##   # #     ####
#    ###      ######     ## #######
###################################