###################################
#     #     #       # # 3 #    E  #
# # # # ### ### # # # # # # #2# ###
# #   #   0      1      #   #T  # #
# # # ##### ##### # # ### ### # ###
# # #   # # # # # # # #   #   # S #
###################################
###################################