###################################
# 1 # #               T E #   #   #
# ##### ### # #2# # ### ##### # ###
#      0#           # 3 #5  # # # #
# # ### # ### #####6### ### # # ###
# # 4 #           # #   #   #   # #
# ### # # # ####### ###S# ### # ###
# # # # # # # # # # # # # # # # # #
###################################