####################################
# #       #   # #   # # 0         ##
### ##### ### ### # # #1# # ### # ##
# #           #   #     #     S # ##
###3# # # # # ### # # ##### # # # ##
# #     #     #           #   #   ##
##### # # # ### # ### # ### # # # ##
#  E  # #  2# #     #   #     # T ##
### # # ### ### # ##### # ### # ####
# #   # # # # #     # # #         ##
####################################
####################################