####################################
#   ######       ##     ##  ########
##   ####     ###  T   ###  ########
##  ####   ## ####     # ###########
### # #    #   #####       #########
#  #        #  #####       #########
#        ## #   ###        ## ###  #
#S #    #  #    #       ## #   #   #
# ##     #        ###   #    #     #
#####    #       ####### ######   ##
# ###  #  ##    ######## #        ##
# ## # ##  #     ######            #
#   # #####  # #  ######           #
##        ## ## # ####### #        #
#          # ##  ####### # #       #
#    #      #    ####  #  ###      #
#  ###    # #      #     ####      #
#######   ## #            ###      #
######## #  ##       ##  ###       #
###### ##   ###  #  #### #         #
#####   ##  ######  ##  ##         #
#####   ##  ## #  ###   # ##     E##
######  ### #   #  ##      ##  #####
####################################