####################################
##  #    #####   #########         #
##         ###     # #####  E   TS #
####        ###          #        ##
####################################