####################################
#        05   7     6 T #   #     ##
# ### ### ### # # ### # # ### # # ##
#         E #3 S        #       # ##
# # # #2# ### ###1# # # ###4### ####
# # # # # # # # # # # # # # # # # ##
####################################