####################################
#3#   # #   #   #  0#     #E  # # ##
# # # # ### ####### # # ##### ### ##
# #        T  #     #2    #    S  ##
# ### # # ### # ##### ### ### # # ##
# 5           4   # #   1         ##
####### ######### # # ### ### # # ##
# # # # # # # # # # # # # # # # # ##
####################################