####################################
# #   #   #   34#  1# #           ##
# # # # # # # ### # # ##### ### # ##
# #       # # # #    0  #       # ##
### ### # # ### ##### ### # ### # ##
# S         7       # 6   #     5 ##
# ### # # # # # # # ###T###E# # ####
#2# #   8   # # # # # # #         ##
####################################
####################################