####################################
# #           #   #   # #     E # ##
##### # # # #####2### # # # # # # ##
#         # # # # S     #      0# ##
# #4### # ##### ### # ### ##### ####
# #       #       # #   # # #   # ##
### # # # # # ###T### # # # # # # ##
# # #    3# #   #     #     #     ##
### # #1# # # ### ### ### # ### # ##
# # # # # # # # # # # # # # # # # ##
####################################