#####################################
#   # #     # #   # #   #       # # #
####### ######### ### ########### ###
#         # # #     #     #   # #   #
# ####### # ### ### ### # # # #######
#     #     # T # #           #   # #
# # # ### # ### # # # # # ####### ###
# # # #   #       # # #       #   # #
# # # # # # # ######### ### ### # ###
# #E# #       # # #   #     #       #
### ##### ### # ### # # #############
# # # #                   #   #     #
# ### # ### # # #S# ##### # # # # ###
#             # # #   # #   #   #   #
# # ### # # # # # ####### ### # # ###
#   # # # #     # # # #       # # # #
#####################################
#####################################