#####################################
#  0            1 # 42  T 3       S #
# # # # ### # # # ### # # # ### #####
# # #    E  #   #   #   # # # # #   #
#####################################
#####################################