#####################################
# ###    #1 ####      ############  #
####      # ####    2##   ########  #
#####    # ######          ######   #
##0     T # ###     # ##  ########  #
#     ##   #   S   E##############  #
#      #    #       #################
#####################################