#####################################
#   #   ##5   ######     0###########
#   ##  ##  1#########   ######  ####
#  #    ###    ################3E  ##
###    ###    T  ############# ##  ##
#     ###   # #   ##########   ######
#     ##  4 ## #   ########    #### #
#   ##### S #   #2#####  ##  ###### #
##  #####     ########   ############
#####################################