######################################
#     # #     #     #         #     ##
### ### # ####### # ####### # ### # ##
#           #   #T#   #           5 ##
######### # # # # #S# ### ##### # # ##
# # #   # 7 # #           #   # #   ##
# ### # # # ### # # # # ### ### ######
# #   # #     # #       #   # 2     ##
# # #E### ##### #1### # #####3### # ##
#0  # #   # 4   6   # # #   # # # # ##
######################################
######################################