######################################
#    1#T       S#           #   # 2 ##
# # # ### # # # ### # ##### ###0# # ##
# # # # #    E    #4    3 # #   # # ##
######################################
######################################