######################################
#         #     #     #  E        # ##
### # # # ### # # # #0### # # ### # ##
# #   # #   # # #     #   T     # # ##
# # # # ### # # ### # # #S### # # ####
# # # # # # # # # # # # # # # # # # ##
######################################