######################################
#     #   #   #   #   T         # # ##
# ##### ### # # # # # # ### ### ### ##
#              1  # #  E    # #   # ##
# # # # ### # # #####0### # # # ### ##
#   # #       #   # #     # # #  S  ##
######################################
######################################