######################################
#         2 #           #         # ##
##### # # # # # # # # # # # # ### # ##
#      6     0#3#               # # ##
# ##### ### # # # # # # ### ###4# ####
#  S  #   #   #E# #   #1#   # T     ##
#5# # # # ### # # # # ##### ### # # ##
# # # # # # # # # # # # # # # # # # ##
######################################