######################################
##        # #      # ##          ### #
###       1  # ## #  # # #       ##  #
#####  #     ### #  E   ##     # ##  #
########   3#  #   0        # ##  2# #
########  ###      S T      ###     ##
######   #####       #    4#   #######
######   ###         ##     #  ####  #
####### ####        #       ######   #
######################################