#######################################
#      #  #   #####  #   ############ #
#     ## # ###    #####   ##########  #
# #  #   ##  ##    ##    ### ######  ##
## #  # ####   #  ##     ##    ##### ##
###  ######## ## # #    ####    #### ##
##   ### ########        ####  ####   #
#    #     ##### #       #### # ###   #
#       S  ##  #  # E #  #####  # #####
#          ##T  ##  #### #####     ####
#### #    ####     #   #  # #####    ##
######         # ##          ###    # #
######   #     #####        #####  #  #
# ###  ###    #####            #   ## #
#  # ## #### #####             #   #  #
# #     #  ######              # #### #
# ##       # #####    # #     # #     #
#      ###    ##      ## ###  #      ##
##    #####    #         ## # #       #
###  # ########             ##        #
###  #  #######  ##          #        #
### #  ###########                    #
####   ### ######               ##  ###
#########   #####                #  ###
#######################################