#######################################
#     # #   #   #S  T   #             #
# # # # # ### # # #E# # # # ### # # ###
# # # # # # # # # # # # # # # # # # # #
#######################################