#######################################
#     #     #   #    0# S       # #   #
### # # # # ##### # # ##### # # #2#####
# #  E  # 4 # T       #   3 # #     1 #
# # # ##### # # # # ### # # # # # # ###
# # # # # # # # # # # # # # # # # # # #
#######################################