#######################################
#   #   4 # # #     #5  #   #       # #
### # ### # # ### # # # # ##### # #####
#     #   #1                          #
# #7#######S# ### # # # # # # # # #####
# #   #     #  E    # #0#  6#     #   #
# # # # ### # ### # #3# # ##### # #####
# # T 2 #   #   #   #   # # # #   # # #
#######################################
#######################################