########################################
#     # #     # #   #       #   #     ##
# # # ### # ### # ##### ##### ### ######
#   #     # #   #     #       #   # # ##
### ### # ### # ##### ### ####### # # ##
#         #     #     # # # # # # #S# ##
# # ########### # # ########### # # ####
# #       # #       # # #   #         ##
# ##### # ##### # ##### ### # # # # # ##
#               #   #               # ##
# ##### ### # # # # # # ##### #T# ######
#     # # # #   #   # #   # #       # ##
### # ### # ##### # ### ### # # ### # ##
#         # #             # # #       ##
######### ### ##### ##### ##### ########
# # #     #       #     # #   # #   # ##
### # # # ### # # # # # # # ### ### ####
#           #     # #       #   # #   ##
# ### ### ##### #E# # ######### ### # ##
#   #   #     #   # # # # # #     # # ##
########################################
########################################