########################################
####    ####   ####T 0S ##########   ###
#### E 1##      ####   # ##########  ###
##       #      #######  ###############
########################################