########################################
#   ######### S E      ##   #   ########
##  ## #######   T #####   ##   ########
###     ####       ##### ####  #####  ##
####    ####        ##  ##  #  #####   #
########################################