########################################
#####  #####    ##### ###  ######  #####
####   #  ### #  #  E   #  ######   0 ##
####   #  # ### #1#  #  ###   ##      ##
##########    ##  ## ###S  # T     #   #
# ## #####           ####2###    ## #  #
# #   ########    # ##########  #   ####
########################################