########################################
#            #    #      ###2 #  #######
#   E          # ## 0  S### ####   ##  #
#     T        ###    #  ##1  # #  ##  #
#### 4 ##      #   ####  ##3     #     #
##### ### ##  ##  #######       # ##   #
# ###  # #  #  #   ####          #  ## #
#  ###     #       ###    ###     # ####
#     #   ##### #  ##    ###       #####
########################################