#########################################
#  ###   0 ##    ######   #####    ##   #
##5#### 1  ## T   #####  # ####   #     #
### ### ##  # ##  ##### ## S####   #   ##
## E## #####4  ##6#  #    3 ###   ## ####
##    2#####  ###  #          #   #  ####
##     ##  ## ##   ####      #       ####
#     ##   # # #   #######   #         ##
#########################################