#########################################
#  ######  ##  ##     #  ## #############
#    ####    #  #            0#   #######
#    ###    ##  ##        # T     ##  ###
##  E1#  ###     #   ##  S##          ###
##      ##   #    #  #   #              #
#           ### ##    #  #              #
#   #            #   #### #             #
#####      ##     #  #   ### #    #######
#########################################