#########################################
#  #  # ####   #  #   #######  #####    #
#        #######  ##  ######   #####    #
# #    S ###### ##   ########  ######   #
## #    #   ###   0  1####### ######    #
# #  5##  #           #######  ####  3  #
# ##   # # #   E       ######   ###     #
##2 ###  # ##    ##     ##  ##  ###T#   #
#      ## # #    ##    4  # 6##### # #  #
#       ##   ##           #  #####  #  ##
#########################################