#####
#   #
# ###
# T #
# ###
#   #
# ###
#S# #
# ###
#E  #
# ###
# # #
# ###
# # #
#####