#####
#   #
# ###
#   #
#S###
#E  #
#T###
#   #
# ###
#   #
#####
# # #
# ###
#   #
#####
#####