#####
#   #
# ###
#S  #
# ###
#E# #
#2###
#   #
#####
#T  #
#0###
#   #
# ###
# 1 #
#####
#   #
# ###
#   #
#####
#####