#####
#2  #
#S###
#   #
# ###
#   #
#T###
#   #
# ###
#   #
# ###
#   #
#####
#E  #
# ###
# 1 #
#0###
#   #
# ###
# # #
#####