#####
#   #
# ###
# T #
# ###
#S# #
# ###
# # #
# ###
# # #
# ###
#   #
# ###
#1  #
# ###
#E  #
#####
#   #
#0###
#   #
#2###
# # #
#####
#####