#####
#T# #
#1###
# # #
#S###
#   #
#2###
#   #
#####
#   #
# ###
#   #
#6###
# # #
#####
#5  #
# ###
#0  #
#3###
#E  #
# ###
#7  #
#4###
#   #
#####
#####