#####
#T E#
# # #
#S  #
#   #
#####