##########################################
# # # #   #     #   #     #   # #       ##
# #####T##### ##### # ### # ### ### # # ##
# #   #           # # #     #   # #     ##
##### # # ##### # ##### # ##### ### ### ##
# # #     # # #     # #      S        # ##
### # # # # # ##### # # ### # # # # # # ##
#     #   #             # #   # #       ##
# # ### # # # # # # # # # ### ### ### # ##
#     #   #     #E#   #   # # #   # #   ##
# ### # ##### ### # # ### ####### # # ####
# # #   #   #     # #     #         # # ##
##### # # # ### # ### ### # # # # # # # ##
#   # # # #   # #   # # #         # #   ##
##########################################
##########################################