##########################################
# # #           # # #   # #       # #   ##
# # # # ####### # ##### # ##### ### # # ##
# #       #                 #           ##
##### # # ##### # # ### # ##### ### #S# ##
# #       #           # #       #     # ##
# ### # ##### # ######### ### # # # ### ##
#       #       #     #  E    # # #   # ##
# # ##### ##### ### ##### # ### # ### # ##
# #         #   # # #     # # #     #   ##
# # ##### ### # ### ### ### # ### ##### ##
# # # #   # #   #   # # #      T#       ##
### ### ### # # ### # # # # # # # ##### ##
# #   # #   # # # # #   # # # #   #   # ##
# # ### ##### ####### # ##### # # # ### ##
#   # # # #           #   #       #   # ##
##### # ##### # ### # # # ### ### # # # ##
# # # # # # # # # # # # # # # # # # # # ##
##########################################