##########################################
# #   #   #     #       #         #     ##
# ##### ### # ### # # # # # ### ### ### ##
# #         # #   #   #     # #     #   ##
# # # ######### # ####### # # ##### # ####
# #     # # #       #       #       #   ##
### ### ### # ##### # ### # # # # ##### ##
#   # # #   #   # #       #   # #   #   ##
### # # # ##### ### # # # ##### # # ######
#   #           # #S    #     # #       ##
####### ####### # # # ##### ### ### ### ##
#   #       # #     # #           2 #   ##
# # ### ##### #E# ### ### # ### ####### ##
#   # #   #1  #   #   #     # #   # #   ##
### # # ##### # # # ### # ### ##### ### ##
# #   #     #           #   # #   #     ##
# # ### # ### ### # # ##### ### # ### ####
#     #   #         # # #     # # 3     ##
# ########### # # ### ### ### ##### # # ##
# # # # #     #     #     #   #     #   ##
### # ### # ##### ### # ##### ##### ######
# # #   # # # #   #     #   #   # # #   ##
# # #0### ####### ### # ##### # # # ######
#   #   #   # #T              # # #   # ##
# # ##### ### # ### # ##### # ### ### # ##
# # # # # # # # # # # # # # # # # # # # ##
##########################################