##########################################
#     #S3 #             #T     E   0    ##
# # # # # #1# #2# # # # # # ### # ##### ##
# # # # # # # # # # # # # # # # # # # # ##
##########################################