##########################################
#6 3 0                    4 #   5       ##
# # # # ###1# # ### # ### # ### # # #S# ##
#       # #2  # E     # # #   #        T##
##########################################
##########################################