##########################################
# # #   #   # #       #         #     # ##
# # # ### # # # ### ##### ####### # ### ##
# #     #       #       #       # E #   ##
##### ### # # # # # #T# ### # # ### ### ##
# #     #         #       #   # #     # ##
# # ### # # # # ### # # # # # ##### # # ##
#   # #   S     #   #   #           #   ##
# # ### # # # # ######### # # # # ##### ##
# # # # # # # # # # # # # # # # # # # # ##
##########################################