######
#  # #
#    #
#   ##
# 0  #
# # ##
# #  #
# # T#
#    #
#    #
######
### S#
# 1  #
#    #
#   ##
#   ##
# # ##
# #E##
# ####
######