######
#T S #
# #  #
#E   #
######