######
#T S #
# #  #
# # ##
#E   #
######