######
#T #E#
#    #
#   ##
#S   #
#    #
######