######
#T #E#
#    #
#1  ##
######
#S 0 #
#    #
######