######
#  #E#
#    #
#   ##
#S   #
#    #
# # T#
######
######