######
#  #E#
#    #
#   ##
#S   #
# # ##
# # T#
#### #
###  #
######