#######
#3S # #
#4# ###
#   1 #
# #0###
#  E# #
#T#####
# #   #
#2# ###
# #   #
# # ###
# # # #
#######