#######
#  1  #
#5#4###
#     #
# # ###
#S    #
# #####
#7    #
#3# ###
#  2  #
### ###
#  0# #
#E# ###
#8#6  #
###T###
# # # #
#######
#######