#######
#  E0 #
# #####
#     #
# #####
#S  # #
# # ###
#     #
### ###
#     #
# # ###
# #   #
# # ###
#     #
# #####
#   # #
# #####
#T# 1 #
# # ###
# #   #
#######
#######