#######
#S  # #
# # ###
#     #
# # ###
# # # #
# # ###
# #   #
# # ###
#     #
# # ###
#   E #
### ###
# T   #
# # ###
#     #
# # ###
#     #
#######
#     #
### ###
# # # #
#######