#######
#     #
# #####
#   # #
# # ###
# #   #
# # ###
#     #
#S#E###
#     #
### ###
# T # #
# # ###
#     #
# #####
# #   #
### ###
#   # #
# #####
#     #
# # ###
#   # #
#######
#######