#######
# #   #
### ###
# E 0 #
### ###
# #   #
# # ###
#     #
# # ###
# T # #
# # ###
#     #
# # ###
#1    #
# # ###
# #   #
# # ###
#     #
# # ###
#   # #
# #S###
# #   #
# #####
# # # #
#######