#######
#     #
# # ###
# #S  #
# # ###
#     #
#2# ###
#1    #
# #####
# # # #
# # ###
# #   #
# #E###
#     #
#0#####
#     #
# # ###
#T  # #
### ###
#4#   #
###3###
#   # #
### ###
#     #
### ###
# # # #
#######