#######
#T  S #
#     #
##    #
#E #  #
#######