#######
# 2ES #
#3# ###
#1  0 #
# #T###
# # # #
#######