#######
# S4E #
#1# ###
#03 # #
#5# ###
#T# 2 #
#######
#######