#######
#     #
#######
#     #
### ###
#S    #
# #E###
#   T #
# # ###
# # # #
#######