########
#     ##
### # ##
#     ##
# ### ##
# S 1 ##
###0####
# # # ##
# #E# ##
# # # ##
# # # ##
# T # ##
##### ##
# # # ##
########