########
#   1 ##
# # # ##
# #  2##
### ####
# #   ##
# ###T##
#   #3##
# #S####
#E#   ##
# ### ##
# 0   ##
### # ##
#     ##
########
########