########
# # S3##
# #6# ##
# # 1 ##
##### ##
# #  4##
# #5# ##
#     ##
#T# #0##
#   # ##
# ### ##
#     ##
# ### ##
# #2# ##
# # # ##
#  7  ##
#E### ##
# # # ##
########