########
# 0   ##
# ######
#E  # ##
# # #1##
#     ##
# ### ##
#     ##
# # # ##
#   S ##
# # # ##
#     ##
### # ##
# T # ##
# ######
#     ##
# ######
# # # ##
########
########