########
# T 0 ##
# # ####
#     ##
# ######
#     ##
##### ##
#     ##
### ####
#     ##
########
# #2  ##
### # ##
#     ##
### ####
#   # ##
# #S# ##
#   # ##
# # #E##
# # #1##
########