########
# 82 5##
#4# # ##
# # T ##
# ### ##
#   E ##
# # # ##
# #   ##
# ### ##
# 6S  ##
##### ##
#1   0##
##### ##
#   3 ##
# ###7##
#     ##
### ####
#     ##
##### ##
#     ##
########
########