########
#   1 ##
# # # ##
# #   ##
# #0####
#     ##
# # ####
#     ##
###4# ##
# #   ##
### # ##
#S  # ##
# # ####
# #   ##
### # ##
#   # ##
### ####
# 3  T##
#2### ##
#    E##
### ####
#     ##
# # ####
# # # ##
########