########
#     ##
### # ##
# # # ##
##### ##
# # # ##
#E######
#     ##
# # # ##
# #   ##
# ### ##
#     ##
# # # ##
#     ##
###S####
#   # ##
### # ##
# # # ##
# # ####
#   T ##
# ### ##
#   # ##
# # # ##
# # # ##
########
########