########
#0#   ##
### ####
#   # ##
# # #8##
#   7 ##
### # ##
#   5 ##
# # # ##
#1    ##
# ### ##
#     ##
# #4####
#  T  ##
# # #S##
#2#6  ##
# # # ##
# # #3##
# # # ##
# # # ##
# # # ##
#    E##
### # ##
# #   ##
### # ##
# # # ##
########