########
#   E ##
#2######
#    T##
#S# #1##
# 03  ##
########
########