########
#2 3E ##
###1# ##
#T0 S ##
# # # ##
#   # ##
# # ####
# # # ##
########