#########
#       #
# # # ###
#   # # #
# ### ###
# E   T #
# # # ###
#  S#   #
##### ###
#   # # #
# # # ###
# #   # #
#########
#########