#########
# # #   #
# # # ###
#   E   #
# # # ###
#   #   #
# # # ###
#2   0# #
# # #####
#1      #
#S# #####
#       #
# #######
#T#3  # #
#########
#########