#########
# #E#34 #
#S# # ###
#  T  6 #
# ### ###
# #   # #
# # # ###
#   #7  #
### #8###
#   #   #
# # #####
# #   1 #
# # # ###
# 25#   #
#0#######
# # # # #
#########