#########
#   # # #
### # ###
#   #   #
# ### ###
#   E # #
# #T#####
# #  S  #
# ### ###
# #     #
### # ###
# #     #
# # # ###
# #     #
# # #####
#   # # #
#########
#########