#########
#     S #
# # #####
# #   # #
##### ###
#   0   #
### #####
#E    # #
# # # ###
#   T # #
# # # ###
#       #
# # # ###
#       #
# # #####
# #     #
# # #####
# # # # #
#########