#########
#       #
# # # ###
# #  0  #
# #######
# S2#   #
##### ###
#     # #
# ### ###
# #     #
# #######
#   E # #
# # #####
#       #
#T# # ###
#   # # #
# # # ###
# 46#   #
#1# # ###
#  3  # #
# # # ###
# #     #
###5#####
# #   # #
#########
#########