#####
#S  #
#   #
# 0T#
#####
#1 ##
#   #
#  E#
#####