#######
#S    #
#     #
# ### #
# #T  #
#  #  #
#  ## #
#    E#
#######