##########
#       ##
# # ### ##
#       ##
#T### # ##
# # # # ##
# # ### ##
#     # ##
# ### ####
#    S  ##
### ######
#E#     ##
#   ######
##########