##########
#     # ##
# ### # ##
#     # ##
# # ### ##
#       ##
# ########
#   S   ##
### #T# ##
#     # ##
### # # ##
#   #   ##
# # # ####
#   #   ##
# # # # ##
# #   # ##
# ########
#    E  ##
# # ### ##
# # # # ##
##########