##########
#   #T  ##
### # # ##
#  S# # ##
###2# # ##
# #   3 ##
# ### # ##
# # #   ##
# ###4# ##
# #     ##
### # ####
#     # ##
### # # ##
# #  0  ##
# # # ####
#    1  ##
# ### ####
#   5 # ##
### # ####
# # E   ##
### # # ##
# # # # ##
##########