##########
#       ##
### # # ##
#     # ##
### ### ##
# # #   ##
### # # ##
# # #   ##
# # ### ##
#S  #   ##
# ### # ##
#   #   ##
# # # ####
# # T   ##
# # ######
#      E##
### ### ##
#       ##
# ### ####
# #     ##
# # # # ##
#     # ##
### # # ##
#   # # ##
##########
##########