##########
# #   # ##
### # ####
#   #   ##
# #T# # ##
#   #3  ##
# ##### ##
#1#   # ##
# # # # ##
# #   # ##
##### # ##
#      4##
# # ### ##
# #     ##
# ### # ##
#  2  # ##
# # # # ##
#   #   ##
# # # # ##
#     S ##
# ########
#   0E  ##
# # ### ##
# #     ##
# # # ####
# # # # ##
##########