##########
#TS1#   ##
#0#E# #2##
# # # # ##
##########