##########
#   S  ###
#    #####
##     # #
#E # #T  #
##########