##########
#   1  2##
#S#T### ##
#E  #   ##
# ###0# ##
# # # # ##
##########