##########
# # 40 3##
#S### #2##
# TE    ##
# ###1# ##
# # #   ##
##########
##########