##########
# #     ##
# ### #0##
#  T#   ##
#S### # ##
#     #E##
# # # ####
# # # # ##
##########