###########
# #     # #
# ### # ###
#  1  # E #
#S# # #####
# # #  2  #
# # # #####
# #   0T  #
# # # # ###
#         #
###########
###########