###########
#         #
##### # ###
#   E   # #
# # # # ###
#S      # #
### ###T###
#     # # #
# # # # ###
#     #   #
### # #####
# # # # # #
###########