###########
#   # #   #
# ### #####
#     # # #
# # ### ###
#   # #   #
### # # ###
#         #
# # #E# ###
#  1#  S  #
# # #######
# #       #
# # # # ###
#T     20 #
# # # #####
#   #     #
##### #####
# # # # # #
###########