###########
#  3      #
### #######
# #E# #1  #
# # # # ###
# # #     #
# ### #####
#     T S #
# # # #####
#   #     #
### # # ###
#  0      #
# #2### ###
#         #
# #########
# #       #
# # # # ###
# #     # #
###########
###########