###########
#    7  # #
# # ### ###
#S# # E # #
###########
#         #
# # #2# ###
#   #     #
# # ### ###
#   #   # #
# # # #####
#  3   4# #
##### # ###
# #     # #
# # ### ###
#         #
# #6#######
# 5  T  1 #
# ###0# ###
# # # # # #
###########