###########
# #T      #
# #### ####
# #     # #
# # # # ###
# # # 0 # #
### #5#####
# #   E # #
# #6#######
#     # # #
# # #######
# #       #
### #######
#       # #
# #1# # ###
#     # # #
# # # # ###
#  3   24 #
# ### # ###
#   S   # #
# ### #####
#     #   #
# # ### ###
# # # # # #
###########