###########
#   # T 0 #
# # #1#E###
#     # S #
# ### # ###
# # # # # #
###########