###########
#5 E    S #
# ### #####
#   4 3 # #
# # # # ###
#   # #   #
# # #1#####
#  T2 # 0 #
###########
###########