###########
#    T#   #
#####E# ###
# #       #
### ### ###
#       # #
### ### ###
#   #     #
#S# # #####
# # # # # #
###########